人	士	人物	人士	人氏	人选
人类	生人	全人类
人手	人员	人口	人丁	口	食指
劳力	劳动力	工作者
匹夫	个人
家伙	东西	货色	厮	崽子	兔崽子	狗崽子	小子	杂种	畜生	混蛋	王八蛋	竖子	鼠辈	小崽子
者	手	匠	客	主	子	家	夫	翁	汉	员	分子	鬼	货	棍	徒
每人	各人	每位
该人	此人
人民	民	国民	公民	平民	黎民	庶	庶民	老百姓	苍生	生灵	生人	布衣	白丁	赤子	氓	群氓	黔首	黎民百姓	庶人	百姓	全民	全员	萌
群众	大众	公众	民众	万众	众生	千夫
众人	人人	人们
人丛	人群	人海	人流	人潮
大家	大伙儿	大家伙儿	大伙	一班人	众家	各户
们	辈	曹	等
我	咱	俺	余	吾	予	侬	咱家	本人	身	个人	人家	斯人
区区	仆	鄙	愚	鄙人	小人	小子	在下	不才	不肖
老朽	老汉
小弟	兄弟
奴	妾	妾身	民女
朕	孤	寡人
职	卑职	下官	奴婢	奴才
贫道	小道
我们	咱	咱们	吾侪	吾辈	俺们	我辈	咱俩
你	您	恁	而	尔	汝	若	乃	卿	君	公
老兄	仁兄	世兄	兄长	大哥
老弟	贤弟	仁弟	兄弟
大嫂	大姐	老大姐
阁下	足下	驾	同志	老同志
陛下	主公	大王	万岁
您老	你咯
你们	尔等
诸位	各位	诸君
他	她	彼	其	渠	伊	人家
他们	她们	他俩	她俩
自己	自家	自个儿	自各儿	自身	本身	自我	本人	小我	我	自	己
别人	旁人	他人	人家
谁	哪个	哪位	张三李四
某人	某
谁	孰	谁人	谁个	何人	哪个	哪位	何许人也
男人	男子	男子汉	男儿	汉子	汉	士	丈夫	官人	男人家	光身汉	须眉	壮汉	男士
爷儿	爷们	爷儿们
先生	子	君	郎	哥	小先生
女人	女子	女性	女士	女儿	女	娘	妇	妇女	妇道	妇人	女人家	小娘子	女郎	巾帼	半边天	娘子军	石女	红装	家庭妇女	农妇	才女
女流	女人家	妇道人家	娘儿们	妞儿
少妇	婆娘	婆姨	娘子	小娘子
姑娘	少女	丫头	千金	小姐	闺女	室女	姑子	黄花闺女	大姑娘	小姑娘	童女	老姑娘	春姑娘
仕女	贵妇人	太太	夫人	少奶奶	奶奶	贵妇
贱人	祸水
村姑	农家女
男女	士女	儿女	红男绿女	男男女女	少男少女
老人	老	老者	老汉	老翁	翁	长老	长者	遗老	耆老	叟	父	老头儿	老头子	老年人	老头	老记	中老年人	白发人	年长者
老朽	风中之烛	枯木朽株	朽木粪土
老寿星	寿星
公公	爷爷	老爷爷	老太爷	老爹	老公公	老爷子	老大爷	老人家	丈人	丈	老	老父	父老	寿爷
老奶奶	老太婆	老妪	妪	媪	老婆儿	老婆子	老妇
老太太	老婆婆	老大娘	姥姥	奶奶	阿婆	嬷嬷	老妈妈	老大妈
老家伙	老糊涂
成年人	壮年人	大人	人	丁	壮丁	佬	中年人
老小	老少	大小	老幼	老老少少	白叟黄童	大大小小
青年人	青年	小伙子	青少年	后生	弟子	子弟	初生之犊	年青人	小伙	小青年	年轻人
知识青年	知青
少年人	少年	苗子	苗	年幼	未成年	未成年人
芝兰	龙驹	千里驹
婴儿	婴孩	婴	新生儿	产儿	赤子	乳儿	毛毛	小儿	早产儿	婴幼儿
宝宝	宝贝	乖乖	囡囡	小鬼	宝贝疙瘩	宝贝儿	小宝宝
儿童	孩童	稚童	童稚	童子	孩子	孩儿	孩子家	小儿	小人儿	雏儿	幼儿	娃儿	娃娃	娃子	小子	小小子	竖子	孺子	稚子	童蒙	幼	童	孩	小	孺	囡	小朋友	小不点儿	少年儿童	童男童女	报童	少儿	小孩	小孩子	幼童	小娃	文童	伢儿	女孩儿	毛孩子	小家伙
妞	妮子	妮儿	丫头	黄毛丫头	阿囡	女孩子	小妞	女童
顽童	小淘气	淘气鬼	孩子头	孩子王	淘气包
男童	男孩儿	童男
高个儿	高个子	大个儿	大个子	巨人	大汉	彪形大汉
细高挑儿	长子
矮子	矮个儿	矮个子	矬子	侏儒	小个子
胖子	大块头	胖小子	重者
瘦子	骨头架子
美女	美人	姝	娥	花	媛	佳人	丽人	仙人	天仙	仙子	仙女	玉女	淑女	嫦娥	西施	尤物	娇娃	佳丽	丽质	红颜	红粉	红袖	蛾眉	婵娟	绝色	国色	小家碧玉	倾国倾城	天香国色	国色天香	靓女	天生丽质
丑八怪	夜叉
麻子	麻脸
秃子	癞子	瘌痢头
豁嘴	豁子	兔唇
结巴	结子	咬舌儿	大舌头
居民	居者	定居者	居住者
市民	城里人	城市居民	都市人
乡民	乡下人	乡巴佬
船民	水上居民
侨民	侨	侨胞	华人	华裔	台胞
本国人	国人	同胞
外国人	外侨	外人	外族	洋人
洋鬼子	鬼子	老外
外族人	外族
中国人	华人	炎黄子孙	唐人
本地人	当地人	土著	土人	土著人
村里人	全村人
外乡人	异乡人	他乡人	外地人	外省人	外来人	外族
同乡	老乡	乡人	乡里	乡亲	邻里	乡党	父老乡亲	故乡人
职工	员工
职员	干部	员司	机关部	老干部	高干
公务员	勤务员	办事员
秘书	文牍	文书	书记	文秘
总务	庶务	管事
会计	会计师	帐房	出纳	出纳员	先生	成本会计	大会计
掮客	经纪人	中人
从业员	营业员	售货员	伙计	店员
列车员	乘务员	乘员
广播员	播音员
理发员	理发师	理发匠	美容师	美发师
空姐	空中小姐
消防人	消防员
承运人	发运人
供给者	供应者
编选者	编委	编撰者
勘察者	勘探者	探索者
工人	工	工友	老工人
工匠	匠人	匠	巧手	巧匠	手艺人	艺人	手工业者
老师傅	师傅
壮工	小工
短工	零工	临时工
苦工	苦力	劳工	雇工	劳务工
学徒工	徒工
木工	木匠
瓦工	泥工	瓦匠	泥瓦匠	泥水匠
石工	石匠
油漆工	漆工	油漆匠	漆匠	油匠
花匠	园丁	老圃	花工
画匠	画工	画师
成衣匠	裁缝
鞋匠	皮匠
铁工	铁匠
海员	船员	水手	潜水员	蛙人
领航员	引水员	领港	领江	航海家	引水人
船夫	船工	船家	船户	船老大	老大	舟子	长年	水工	船东
舵手	掌舵	艄公	掌舵人
驾驶员	司机	驾驶者	车手	的哥	驼员	机手
飞行员	航空员	试飞员	空哥
宇航员	航天员
驭手	御手	掌鞭	车把式	车夫	车把势
操作员	操纵员
搬运工	挑夫	脚夫	脚力	脚行	苦力	红帽子
炊事员	厨师	厨子	大师傅	庖	炊事	主厨	名厨
火夫	司炉	生火	伙夫	火头军
邮递员	邮差	信差	信使	绿衣使者	通信员	投递员
交通员	交通	通讯员
联络员	联络官	联系人
门房	号房	传达	门子	阍者	看门人	看门	门卫	守备
服务员	招待员	伙计	侍应生	侍者	茶房	女招待	服务生
堂倌	酒家	店家	跑堂儿的	店小二
清洁工	清道夫	清扫工
勤杂工	工友	茶房	勤杂人员
农民	农夫	农	庄稼人	庄稼汉	泥腿子	农家	老乡	村夫	庄户人	村民	庄浪人	庄户人
小农	老农
佃农	佃户
上中农	富裕中农
牧民	牧人	牧工	牧女	牧户	游牧民
渔民	渔翁	渔家	渔夫	渔父	打鱼郎
猎手	猎人	猎户	弓弩手
樵夫	樵	刍荛	樵姑
饲养员	倌	饲养户
羊倌	羊工	牧羊人
放牛郎	牛郎	牧童	放牛娃	牛倌
马夫	马倌
屠夫	屠户
商人	商贩	买卖人	商贾	贾	商	市侩	经纪人	生意人	巨商	商户	下海者
商旅	行商	行贩	单帮	倒爷
小贩	摊贩	贩子	小商	小商贩	二道贩子
客帮	客商	客人	客
卖家	卖方	发包方	卖主
军官	武官	官佐	官长
指挥员	指挥官
总司令	司令员	统帅	主帅	元帅	大元帅	大将军	主将	元戎	将帅	帅	麾下	老帅	司令	司令官
将领	将军	大将	将	名将	武将	战将	儒将	名将	良将	爱将
副将	偏将	裨将
虎将	猛将	闯将	骁将	枭将	飞将军	强将	悍将
老总	长官	警官
将士	官兵	将校	指战员
军人	武人	武夫	兵	兵家
荣誉军人	荣军
边防军	戍边人
士兵	兵士	战士	士卒	兵卒	兵丁	兵员	战斗员	大兵	老总	兵	卒	兵油子	匪兵	老弱残兵	精兵	卒子	新兵	小将	老将	虾兵蟹将	兵工
女兵	娘子军
士	军士
步兵	陆军
骑兵	轻骑	铁骑	骑士
水兵	水师	水军	海军
侦察兵	侦察员	尖兵	探子	便衣
哨兵	卫兵	岗哨	步哨
航空兵	空军
伞兵	空降兵
工兵	工程兵
号兵	司号员
警卫员	警卫	护兵	护卫	马弁	亲兵	卫士
通信员	勤务兵
退伍兵	退伍军人
复员军人	转业军人
老兵	老红军	老八路	红军
兵圣	战神
官军	官兵们
情报员	谍报员	间谍	特务	特工	特	细作	坐探	探子	眼线	眼目	耳目	信息员	克格勃	物探	通谍
敌特	敌探	奸细
译电员	分析员
警察	警	巡警	巡捕	警士	警官	警员	警力	军警宪特	处警
人民警察	民警	公安人员
捕头	警长	探长
侦探	暗探	密探	包探	警探
看守	狱卒	狱吏	警监
行刑队	刽子手	刀斧手
审判员	审判员	陪审员	承审员	法官	推事	审判官	大法官	司法员	执法者	铁法官	司法官
检察官	检察员	检查官
律师	辩护律师	辩护士	辩士	辩护人
征稽	考稽	税稽	税务员
教师	老师	师	导师	师长	师资	教员	园丁	先生	教书匠	讲师	教工	教职工	良师	民办教师	教育工作者	教育者	名师
教官	教练	教练员	教头	主教练
教养员	保育员	阿姨
塾师	师傅	老夫子	业师	夫子
学生	生	学员	学童	桃李	学习者
门生	门下	门徒	受业	学子	弟子	徒弟	入室弟子
高足	高徒	高材生	得意门生	高才生
寄宿生	住读生	住校生
定向招生	委培生	定向生
学习者	学人
运动员	选手	健儿
裁判员	裁判	评委
医生	医师	医	大夫	郎中	先生	白衣战士	卫生工作者
国医	中医	中医师
良医	名医	神医
太医	御医
助产士	接生员	收生婆	产婆	老娘	姥姥
护士	看护	卫生员	看护者
作者	笔者	撰稿人	写稿人	著者	起草人
执笔人	主笔
译者	翻译	译员	通译
记者	新闻记者
新闻工作者	新闻官
媒体	传媒
编辑	编者	编辑者	编写者	编辑家	名编辑	美编	编导者
总编辑	总编
创意者	创意人
演员	艺人	优伶	戏子	优	伶	艺员	饰演者	表演者	扮演者
明星	影星	星	超巨星	超新星	大腕
女演员	坤角儿	女星
歌手	歌姬	歌舞伎	伎	歌者	歌星	演唱者	唱工	唱头
主角	角儿	正角儿
配角	班底	龙套	武行
名角	名伶	名优	红角
生角	生
老生	须生	外	末
旦角儿	旦	花衫	花旦	旦角	名旦
青衣	正旦
彩旦	丑婆子
丑角	小丑	丑	小花脸	三花脸	金小丑
花脸	净角	净	架子花
大花脸	大面	黑头	铜锤
二花脸	武二花
演职员	演职人员
表演家	表演艺术家
舞者	舞星
知名演员	名演员
琴师	乐师	乐手
鼓师	鼓手
号手	吹鼓手	吹号者
演奏者	演奏员
剧团人员	剧中人
编剧	剧作者
文艺工作者	艺术工作者
模特	模特儿
阴阳家	阴阳生
魔法师	魔术师
巫师	巫神	神巫	师公	巫	神汉
女巫	巫婆	神婆	仙姑
劳动者	生产者	小生产者
无产者	无产阶级
实施者	执行者
奴隶	农奴	娃子	奚	臧
小市民	城市贫民
上访者	来访者
接访	受访者
投保人	股民
候选人	候选者	应选人
选民	选择者	选举人	投票者
跟随者	追随者	支持者	拥护者	维护者
反驳者	反对者
抗议者	示威者	游行者
仆人	佣人	下人	奴仆	奴婢	仆役	家丁	家奴	当差	差役	雇工	佣工	公仆	孺子牛	繇
男仆	苍头
童仆	家童	书童	小厮	竖子	马童	扈
女仆	仆妇	女佣	女佣人	老妈子	妈	保姆	娘姨	阿姨	女奴
婢女	婢	丫鬟	丫头	使女	青衣	侍女	妮子
奶妈	奶娘	奶子	乳母	嬷嬷	乳娘
奴才	小人	看家狗	犬马
仆从	长随	跟班	跟脚	伙计
侍从	扈从	侍者
随从	随员	左右	随行人员
封建主	领主
地主	二地主	庄园主	恶霸地主	田主	恶霸地主	东佃
东家	老爷	少东家
农奴主	奴隶主	雇主
士绅	绅士	乡绅	官绅	缙
豪绅	劣绅	土豪劣绅	土豪	员外
资本家	资产阶级	财阀	寡头	大王	财政寡头	金融寡头	资产者	有产者	放贷人
老板	财东	业主	小业主	老板娘	行东
店主	店家	少掌柜	掌柜	甩手掌柜
经营者	纳税人
出资人	投资人
皇帝	帝	王	上	君	天子	天皇	帝王	君王	国王	国君	君主	当今	皇上	圣上	陛下	主公	九五	九五之尊	可汗	单于	大帝	沙皇	天骄	天王	五帝	太岁	王者	至尊	统治者
女皇	女王
暴君	桀纣
皇后	王后	娘娘
妃子	贵妃	王妃	妃
贵人	后宫	嫔妃
皇室	王室	皇家	皇亲国戚	宗室
太后	皇太后	老佛爷
太子	皇太子	东宫	储君	皇储	殿下	春宫	王储
王子	皇子
公主	郡主
王孙	金枝玉叶	琼枝玉叶	玉叶金枝
王公	公爵	王爷	千岁爷	亲王	千岁	诸侯
贵族	万户侯	大公
权贵	显贵	显要	贵人
太监	宦官	公公	老公公	阉人
宫女	宫娥
女官	女史	女宫
官吏	臣子	臣僚	臣	官	吏	官长	官僚	官府	父母官	群臣	官儿	官宦	命官	地方官	官爵
大臣	重臣	大吏	达官	当道	大员	三九	三朝元老	高官贵爵	达官贵人	高官厚禄	鼎
芝麻官	知府	县令
忠臣	忠良
奸臣	坏官
清官	青天	廉吏	廉者
赃官	贪官	贪官污吏	饕餮之徒
差役	公差	公人	皂隶	衙役	走卒	听差	杂役
宰相	丞相	上相	首相	相公	中堂	尚书
秀才	生员
幕宾	幕僚	师爷	老夫子	阁僚
门客	门下	食客	篾片	帮闲	马前卒
使者	使节	使命	使	行使	大使	行李	说者
领袖	元首	首领	首脑	主脑	法老	资政	特首
头领	头脑	头子	头目	头儿	头头	把头	大王	魁首	魁	酋	头人	带头人	领头雁	领导干部	党首	领导人	决策人	当权者
控制者	操纵者	掌握者
领导	负责人	首长	长官	主管	主任	第一把手	官员	决策者	管理者	企业主	企业管理者	领导人员	领导者	经营管理者
领队	总指挥	组织者	指挥者	管理员	大班	总指挥员	管理人
监工	工头	拿摩温	矿长	工段长	工长	带工头	监管者	总监
创建者	创立者	创建人	创作者	缔造者	开创者	主创者	奠基人
创业者	创业人
策划人	策划者	规划者
首倡者	首创者	领头人
倡导者	倡议者	发起人	提出者
主办人	主办者
经办人	经办人员
名人	名流	名士	名家	名宿	闻人	先达	知名人士	头面人物	风云人物	风流人物	政要	球星	巨星	名匠	社会名流
要人	要员	巨头	大亨	大人物
隐士	逸民	处士	山民	隐君子
小人物	老百姓	无名氏	无名小卒	无名之辈	小卒	普通人
健康人	好人	正常人	常人	平常人
病人	病家	病员	病号	患者	病夫	病包儿	药罐子	病秧子	患儿
植物人	瘫子
疯子	疯人	痴子	狂人	神经病
伤员	伤号	彩号	伤兵	伤病员	受伤者	伤者	受难者	伤亡者	伤残人员
残废	残缺	废人	非人	残疾人	伤残人	智残人	畸形儿
跛子	瘸子	拐子	跛脚	瘸腿
驼子	驼背	罗锅儿
瞎子	盲人	瞍	盲童
哑巴	哑子	哑女
孕妇	妊妇	双身子	大肚子	产妇	孕产妇
鳏寡孤独	孤寡	孤儿寡妇
鳏夫	孤老	孤寡老人
寡妇	孀妇	遗孀	望门寡
孤	孤儿	遗孤	弃儿
孤魂	孤鬼	独夫
光杆儿	光杆司令	孤家寡人	独个儿	单干户	单人
单身汉	独身汉	光棍儿	单身者
富翁	财主	财东	老财	阔老	大户	大腹贾	暴发户	富豪	豪富	有钱人	财神	财神老爷	富人	富家	大款	富人	富家	巨贾	豪商巨贾	万元户	巨富	百万富翁	富商
阔少	大少爷	小开
债主	债权人
吸血鬼	寄生虫
穷人	穷鬼	穷光蛋	穷棒子	寒士	贫民	穷骨头	贫困者
乞丐	乞	丐	花子	叫花子	要饭的	乞讨者	跪丐
债户	负债人	借债人	债务人	欠款人	借款人
帮扶户	保户
闲杂人员	无聊者
幸运儿	福人	福将	福星	不倒翁	天之骄子	骄子	幸运者
红人	宠儿	嬖	大红人
可怜虫	小可怜儿	叩头虫
无辜	俎上肉	被冤枉者
出气筒	受气包
瓮中之鳖	网中之鱼	涸辙之鲋
众矢之的	过街老鼠	怨府	落水狗
屈死鬼	冤魂	怨鬼
被害人	受害人	事主	被害者	受害者	遇害者
当事人	当事者
冤大头	大头
替身	替死鬼	替罪羊	牺牲品	垫脚石
祸胎	祸根	祸端
火主	火头
死难者	罹难者	莩
难民	难胞	难侨
灾民	流民
逃亡者	逃犯	亡命
流浪汉	游民	流民	浪人	无家可归者	流浪者	瘪三	无业游民
败兵	乱兵	残兵	散兵	散兵游勇	残兵败将	余部
俘虏	俘	伤俘	战俘	活口	舌头	囚
人质	质子	质	肉票
违反者	违者	违章人
不合格者	不符合条件者
输家	失败者	输者
旅客	客人	旅人	游子	行人	行者	行旅	客
过路人	过客
游人	游客	旅游者	观光者	港客	观光客	旅行者	漫游者	旅行家	度假者	游士
乘客	司乘人员
参观者	观赏者
亲戚	亲属	本家	亲眷	六亲	戚	亲族	氏	亲朋好友
外戚	远房
血亲	宗亲
姻亲	亲家	远亲	葭莩	葭莩之亲
眷属	亲属	家属	家眷	家小	老小	妻小	妻孥	骨肉	家人	家室	亲人	家口	妻儿老小	妻儿	妇婴
女眷	内眷
侨眷	侨属
曾祖	曾祖父	老爷爷	太公	太爷	太翁	曾父
曾祖母	老奶奶	太婆
祖父	太爷	爷爷	爷	爹爹	老爹	公公	阿爹	太公	太翁	祖	老太公
祖母	奶奶	婆婆	太婆	高祖母
叔祖	叔公
叔祖母	叔婆
外祖父	外公	公公	老爷	姥爷
外祖母	外婆	姥姥	老娘	家母
父	父亲	爷	爹	大	翁	爸爸	老子	爹爹	老爹	阿爹	阿爸	椿	太公	大人	爸	生父	爹地	慈父
令尊	老太爷	老爷子
继父	后爹
养父	义父	干爸
先父	先人
母	母亲	慈母	阿妈	妈妈	妈	娘	萱	内亲	生母	娘亲	亲娘
令堂	老太太	太君
家母	老母	老娘
庶母	姨娘
继母	后母	后妈	后娘	晚娘
养母	义母	干娘	干妈
父母	双亲	二老	爹娘	爹妈	堂上	上下	椿萱	大人	上人	老人	老人家	老亲	家长	考妣	父母亲	养父母	严父慈母
保护者	保护人	衣食父母
父子	爷儿俩
伯父	伯	大伯	大爷	伯伯	大
伯母	大妈	大娘	大大
叔父	叔	叔叔	季父	表叔	堂叔
叔母	婶	婶母	婶子	婶婶	婶娘
姑父	姑夫	姑丈
姑母	姑	姑姑	姑妈	姑娘	姑婆
姨父	姨夫	姨丈
姨母	姨	姨儿	姨妈	阿姨	姨娘	姨婆
舅父	舅	舅舅	娘舅	小舅	表舅	大舅	郎舅
舅母	舅妈	妗子	妗
公婆	姑舅
公公	公	翁	舅	嫜	老公公
婆婆	婆母	老婆婆	阿婆	姑	婆
岳父	岳丈	丈人	泰山	岳	老丈人	娘家人
岳母	丈母	丈母娘
夫	丈夫	爱人	男人	先生	女婿	老公	汉子	当家的	人夫	那口子
老伴	老头子	爷们	老伴儿
郎	郎君	官人	良人	夫子	夫君	夫婿	相公
妻	妻子	爱人	妻室	夫人	女人	老婆	太太	家	婆娘	婆姨	娘儿们	娘子	家里	老小	媳妇儿	老婆子	老伴	内	内助	妻妾	爱妻	贤内助
内人	拙荆	屋里
嫂夫人	尊夫人
发妻	元配	大老婆	正房	前妻	糟糠	糟糠之妻	原配
填房	继配	继室	续弦	后妻
妾	小	姬	小老婆	偏房	侧室	二房	姨太太	姨娘	陪房
夫妻	夫妇	两口子	小两口	老两口	家室	终身伴侣	伉俪
鸳鸯	鸾凤	比翼鸟	并蒂莲	连理
配偶	偶	逑
兄	兄长	哥	哥哥	阿哥	昆	老大哥	父兄
长兄	大哥
家兄	胞兄
弟	弟弟	兄弟	阿弟	棣
堂哥哥	堂兄
师哥	师兄
兄弟	弟兄	手足	哥儿	昆仲	雁行	棠棣	小兄弟	哥们	哥俩	哥们儿
同胞	亲兄弟	胞兄弟
表兄弟	老表
姐	阿姐	姐姐	姊	老姐儿
妹	阿妹	妹妹	妹子	娣	胞妹
姐妹	姊妹	姐儿
连襟	连袂	娅
嫂子	嫂	嫂嫂	大嫂	兄嫂
弟妇	弟妹	婶	弟媳	婶婆
姐夫	姊夫
妹夫	妹婿
妻舅	舅子	舅舅
内兄	大舅子
内弟	小舅子	妇弟
姑	姑娘
大姑	大姑子
小姑	小姑子
大姨	大姨子
子	儿子	儿	男	崽	子嗣	小子	幼子
养子	义子	螟蛉	干儿子
继子	继嗣
小儿	犬子
令郎	少爷	相公	公子	哥儿
女	女儿	闺女	姑娘	丫头	囡	幼女	姑娘家	丫	妮
令爱	千金	女公子
养女	义女
子女	儿女	孩子	男女	骨血	囡	亲骨肉
心肝	宝贝	心肝宝贝	宠儿	命根子	掌上明珠	命根	宝贝儿
独子	独生子	独苗	单根独苗	独生女	独生子女
双胞胎	孪生子
混血儿	混血种	杂种
媳妇	媳	妇	儿媳	儿媳妇儿	子妇	儿媳妇	侄媳妇	孙媳妇
女婿	婿	子婿	娇客	半子	坦	倩	甥	孙女婿	侄女婿
佳婿	乘龙快婿
赘婿	招女婿
姑老爷	姑爷
侄	侄子	表侄	内侄	侄儿
侄女	表侄女	内侄女
甥	外甥
甥女	外甥女
孙	孙子	嫡孙
曾孙	重孙	祖孙
曾孙女	重孙女
外孙	外孙子
鼻祖	始祖	太祖	高祖
创始人	开山	祖师	祖师爷	元老	不祧之祖	开山祖师	老祖宗	奠基者	开拓者
前人	先驱	前驱	先驱者	先行者	先辈	前任	过来人
引进者	推荐者
今人	时人	世人	近人
一代人	当代人
后人	后代	后来人	接班人	继承人	后任	后者	后世	传人	子孙后代	继任者	继承者	来人	膝下
古人	原人	元人	原始人	猿人
祖宗	祖上	祖先	先人	先世	先祖	祖辈	上代
长辈	长上	长者	尊长	父老	老前辈	前辈	老一辈	先辈	老人	上人	老辈
父辈	大伯	伯父	老伯	世叔	叔叔	大叔	大爷	叔	爷	堂叔
大妈	大娘	大婶
侪	同龄人
晚辈	晚	小辈	下辈	后辈	后生	后进	子弟	下一代	新一代
子孙	子嗣	儿孙	后代	后人	后嗣	后生	后裔	苗裔	裔	胄	后	裔	嗣	胄	胤	遗族	子代
受益者	受益人
朋友	友人	友好	友朋	交游	朋	友	哥儿们	宾朋
好友	挚友	执友	密友	契友	稔友	相知	知交	知音	知心人	至交	忘年交	莫逆之交	至好	至友
旧交	旧友	旧故	故旧	旧	故人	故交	老朋友	老友	老相识
新交	新知	初交
难友	患难之交
益友	诤友	良友	良师益友	师友
世交	世谊
诸亲好友	亲友	亲朋	亲朋好友	至亲好友	四座宾朋
教友	校友
恩人	恩公	救星	重生父母
仇人	敌人	仇敌	仇家	寇仇	对头	冤家	仇	冤家对头	大敌
死敌	死对头	眼中钉	肉中刺
外敌	外寇
残敌	穷寇
夙仇	夙敌	夙世冤家	宿敌
对手	对方	敌手	敌	敌方	挑战者
自己人	知心人	贴心人	私人	近人	亲信	腹心
外人	局外人	陌生人	生人	路人	第三者	闲人	异己	旁观者	陌路
邻居	邻人	邻舍	邻里	近邻	街坊	左邻右舍	比邻	东邻西舍	老街旧邻	邻家	乡邻	远邻
一伙	一伙子	同伙	难兄难弟
一路货	狐群狗党	一丘之貉	同党
同伴	同伙	伙伴	伴侣	伴	伴儿	侣	侣伴	俦	小伙伴
伙计	搭档	一行	一起	同路人	旅伴	老搭档
同道	同调	与共
合作者	合作方	合伙人
把兄弟	拜把兄弟	盟兄弟	八拜之交	同盟者
同学	同窗	同班	学友	校友	同桌	同校	同室
学长	学兄
同事	同人	同仁
同僚	袍泽
主人	主	东家	东道主	东	地主	主人公	东道	主人家	主子	庄家	东道国	主人翁
主妇	管家婆	内当家	女主人
寄主	宿主
客人	宾客	宾	客	来宾	来客
贵宾	上宾	佳宾	座上客	贵客	座上宾
男宾	男客
宾主	主客
接受方	接受者
顾客	主顾	顾主	买主	客	客官	消费者
购买者	买客	买者	买家	支付方
消费群	购买群	消费层
成员	分子	积极分子	活动分子
人马	队伍	原班人马
党徒	党羽	徒子徒孙
私党	死党
上级	上司	上面	上边	上头	长上	上峰	顶头上司
下级	部下	下属	属下	下面	下头	僚属	部属	属员	麾下	手底下	手下人	二把手
平级	同级
助手	副手	副	助理	帮办	下手	帮手	羽翼	臂助	僚佐	左右手	膀臂	臂膀	股肱	助理员	帮厨
参谋	顾问	军师	师爷	智囊	谋士	策士	谋臣	总参	奇士谋臣
靠山	后台	后盾	腰杆子	支柱	后台老板
师傅	师父	师
师母	师娘
徒弟	徒	学徒	练习生	徒子徒孙	徒孙
物主	主人	原主	本主儿	所有者	持有人	持有者
屋主	房东	房主	二房东	房产主
收信人	接收者
寄卡人	寄信人	写信人
主持人	主席	召集人	主持者
司仪	打理	礼宾司
与会者	到会者
演讲者	讲话者	发言者
专人	专差	专使	专员
特派员	全权代表
钦差大臣	钦差
代表	代办	代理人	买办	委托人
代言人	发言人	喉舌
见证人	见证	证人	活口	知情人	知情者
保证人	保人	保	担保人	责任者	责任人	总负责人	行为人	责任人员	承担者	法人
中间人	中人	中
调解人	调人	和事老	调解者
仲裁人	鉴定者	公证人	评判人	审判长	公证员
证婚	证婚人
被告人	被上诉人	被告
举报者	举报人	报案人
介绍人	引线人
媒人	媒介	媒婆	媒	介绍人	月老	月下老人	红娘	元煤
男傧相	伴郎
伴娘	喜娘
中介	中介人
新郎	新人	新郎官
新娘	新娘子	新人	新媳妇儿	新妇	新人	新嫁娘	新娘
情人	情侣	冤家	对象	朋友	爱人	意中人	心上人	恋人	爱侣	有情人
男朋友	情郎	欢	男友
女朋友	女友
姘头	相好	外遇
情夫	姘夫	奸夫
情妇	姘妇	奸妇	二奶
王八	乌龟	绿头巾
英雄	豪杰	英豪	英杰	好汉	烈士	志士	枭雄	英雄好汉	英雄豪杰	民族英雄	群雄	英雄汉	群英	无名英雄	雄鹰
有志者	有志之士
硬汉	硬骨头	大丈夫	血性汉子	猛士	硬汉子	铁汉	勇敢者	勇者
烈士	先烈	国殇	英烈
勇士	武士	武夫	壮士	飞将军	好样儿的	斗士	大力士
侠客	侠	武侠	游侠	豪侠	豪客	义士
懦夫	胆小鬼	软骨头	孬种	窝囊废	脓包	孱头	狗熊
懒汉	懒虫
好人	明人	良民	良	令人	本分人	良善	善人	好心人	热心人
君子	高人	仁人君子	正人君子	仁人志士	志士仁人	谦谦君子	使君子
圣贤	圣	贤	圣人	贤人	哲人	高人	完人	贤达	贤能	贤哲	尧舜	先知	先知先觉	贤良	贤淑	医圣	哲	乡贤
先贤	先哲	前贤
元老	长者	泰山	泰斗	泰山北斗	鲁殿灵光
坏人	歹人	歹徒	败类	丑类	坏分子	坏东西	狗东西	癞皮狗	坏蛋	混蛋	禽兽	衣冠禽兽	无耻之徒	跳梁小丑	幺麽小丑	残渣余孽	谬种	破蛋	鼠类
小人	小丑	鼠辈	势利小人	阿谀奉承者
土棍	地痞	地头蛇	恶棍	光棍	无赖	恶人	乔
恶霸	霸	霸王	土皇帝	元凶
豪强	豪门
豺狼	魔鬼	魔王	蛇蝎	恶魔	虎狼	阎罗	阎王	活阎王	混世魔王	鬼魔	魔头
暴徒	强暴	凶残	不逞之徒	亡命之徒
奸邪	奸人	奸宄	佞人	奸佞	妖孽	祸水	害人虫	九尾狐	害群之马	牛鬼蛇神
野心家	奸雄	枭雄
独裁者	独夫	铁腕人物	铁腕
老好人	好人	好好先生	菩萨	活菩萨	老实人
凶人	凶神	夜叉	饕餮	凶神恶煞
泼妇	悍妇	雌老虎	母夜叉
伪君子	假道学	笑面虎	两面派	变色龙	投机分子	乡愿
滑头	油子	老油子	老油条	老江湖	老狐狸	油嘴
吝啬鬼	守财奴	看财奴	小气鬼	铁公鸡	守财
市侩	势利眼	势利小人	市井之徒
造假者	弄虚作假者
孝子	孝子贤孙
逆子	孽障	业障	孽种	不肖子孙	不孝之子	不成人子
贞妇	烈女
荡妇	淫妇	破鞋
骚货	妖精	狐狸精	贱货	贱骨头
浪子	败家子	公子哥儿	花花公子	膏粱子弟	衙内	恶少	纨绔子弟
色鬼	色情狂	渔色之徒
老顽固	死顽固	顽固派	死硬派	死心眼儿	古董	骨董	老古董
学究	腐儒	迂夫子
急性子	直性子	直肠子
炮筒子	大炮	快嘴
慢郎中	慢性子	温吞水
话匣子	碎嘴子	贫嘴	长舌妇
应声虫	尾巴	传声筒	留声机
馋嘴	馋猫子	饕餮
夜游神	夜猫子
怪人	怪物	怪胎	奇人
知识分子	文化人	读书人	先生	生员	书生	生	秀才	夫子	儒	儒生	士	士人	士大夫	文人	学子	斯文	文人墨客	文人	学士	莘莘学子	文人学士	一介书生	臭老九
文弱书生	白面书生
学者	鸿儒	大师	宗师	耆宿	名宿	老先生
作家	大作家	文豪	文宗	文学家	笔杆子	大手笔	散文家	写家	女作家	作家群
诗人	词人	骚人	骚客
诗仙	诗圣	词宗
画家	画师
寒士	措大
书呆子	老夫子	迂夫子	书痴
文痞	文侩
文盲	睁眼瞎子	半文盲	睁眼瞎	科盲
大老粗	土包子
内行	行家	熟手	里手	好手	老手	把势	把式	通	一把手	快手	老资格	熟练工	内行人	行家里手
专家	专门家	家	师	学者	大方	大家	土专家	学家
识途老马	宿将	三朝元老	老将
骨干	基干	桢干	主角	支柱	顶梁柱	擎天柱	台柱子	柱石	栋梁	中坚	中流砥柱	台柱	栋梁之材
外行	门外汉
生手	新手
俊杰	豪杰	杰	英	豪	英豪	俊秀	英华	女杰
人杰	翘楚	魁首	状元	高明	尖儿	尖子	超人	骥	大器	佼佼者
人才	材	材料	佳人	才子	奇才	天才	英才	千里驹	麟凤龟龙	精英	人材	一表人材	栋梁材	有用之才	怪杰	才女	才子佳人	贤才	彦
女将	巾帼英雄	女强人
能手	能人	干将	健将	王牌	权威	好手	上手	国手	高手	妙手	圣手	硬手	一把手	大师	宗师	大王	宗匠	巨匠	能工巧匠	名手	棋手
多面手	通才	全才	通人	百事通	万事通
新秀	后起之秀	龙驹	新锐
庸中佼佼	强者	强手	强手如林
高才生	七步之才	巨子
聪明人	智者	智囊	智多星	诸葛亮
明眼人	有识之士	明白人	亮眼人
机灵鬼	猴儿	鬼灵精
笨伯	笨蛋	笨人	笨货	笨家伙	愚人	蠢人	蠢货	蠢材	木头	木头人儿	愚氓	木头人
饭桶	草包	废物	乏货	朽木	二五眼	窝囊废	酒囊饭袋	行尸走肉	朽木粪土
傻子	傻瓜	二百五	呆子	低能儿	痴子	白痴	傻帽	二愣子
庸人	庸才	凡人	凡庸	中人	平流	阿斗	匹夫	井底之蛙	凡夫俗子	等闲之辈	庸者	井底蛙
绣花枕头	纸老虎
半瓶醋	二百五	半吊子	二把刀	万金油
浑蛋	混蛋	妄人
活宝	宝贝	宝贝儿
糊涂虫	糊涂蛋	马大哈
模范	标兵	表率	榜样	师表	轨范	楷范	英模	典型	丰碑
劳模	劳动模范
先锋	急先锋	开路先锋	先行官	先遣	先行者
功臣	元勋
爱好者	发烧友
教徒	信徒	善男信女	信教者
佛	菩萨	祖师	罗汉	金刚	十八罗汉
沙门	僧尼	僧人	出家人
僧徒	僧侣	僧	和尚	沙弥	道人	行者	头陀	高僧
尼姑	尼	姑子	师姑	仙姑	比丘尼
禅师	活佛	大师傅	大师	师父	法师	上人
住持	方丈	当家的
道教徒	道徒
道士	法师	方士	老道	妖道
伊斯兰教徒	回教徒	穆斯林
天主教徒	天主
枢机主教	红衣主教
神甫	神父
耶稣教徒	基督徒
反动派	反革命	反	反动分子	造反派	批斗者
反派	反面人物
匪帮	匪徒	白匪	黑社会
刽子手	屠夫
战争贩子	战争狂人	战犯
叛徒	内奸	奸	逆	叛逆	叛乱者
卖国贼	国贼	民贼
奸贼	贼	蟊贼	独夫民贼
儿皇帝	傀儡
罪犯	罪人	人犯	囚	囚犯	囚徒	犯人	阶下囚	监犯	释放者
死囚	死刑犯
凶犯	凶手	杀人犯	刺客	杀手
主犯	要犯	首恶	正凶	元凶	罪魁	主谋	主使	祸首	罪魁祸首	首犯	主凶
从犯	同谋犯	同案犯
逃犯	在逃犯	漏网之鱼
教唆犯	教唆者
窝主	窝家
嫌疑人	疑凶
强盗	盗	寇	匪	匪徒	土匪	强人	盗匪	匪盗	盗贼	豪客	异客	歹人	胡匪	胡子	盗寇
匪首	盗魁	草头王
草寇	绿林	绿林好汉	草莽英雄
殖民者	殖民主义者
窃贼	贼	小偷	瘪三	梁上君子	鸡鸣狗盗	破门而入者
惯贼	惯窃	惯偷	惯盗
盗码者	黑客
剽窃者	盗卖者
侠盗	家贼	飞贼	工贼
入侵者	征服者	侵略者
流氓	痞子	泼皮	光棍	无赖	兵痞	无赖汉	渣子	刺儿头	盲流	刺头
二流子	浪子	浪人	阿飞
骗子	拐子	骗子手	诈骗者	奸徒
投机商	奸商	黄牛党	黄牛	投机者	经济人
毒贩	毒枭	贩毒者
走狗	狗腿子	腿子	鹰犬	奴才	帮凶	打手	走卒	爪牙	喽罗	汉奸	洋奴	鹰爪
赌徒	赌棍	赌鬼	赌客
酒徒	大户	酒鬼	醉鬼	醉汉
烟鬼	隐君子	烟民	吸烟者
妓女	妓	娼	娼妓	娼妇	婊子	花魁	神女
艺妓	摇钱树
暗娼	私娼	野鸡
男妓	相公
鸨母	鸨儿	掌班	妈妈	老鸨
龟奴	乌龟	相帮	王八
嫖客	孤老	客人	客
物	实物	东西	家伙	玩意儿	钱物	玩意
物质	质	素
占有物	专有物
物体	体
整体	通体
晶体	晶	结晶体	结晶	晶粒
水晶体	晶状体
绝缘体	非导体
机体	有机体
等价物	同系物
附属物	附着物
样片	抽样
硝酸	王水	硝镪水
醋酸	乙酸	冰醋酸
烧碱	火碱	苛性钠	氢氧化钠
碳酸钠	大苏打
硫酸铜	胆矾
明矾	白矾　
硅	单晶硅	多晶硅	结晶硅	单晶	硅单晶
硫磺	硫
蛋白胨	蛋白质	活质	干酪素
正离子	阳离子
等离子	等离子体
生物	底栖生物	浮游生物	古生物	海洋生物	漫游生物	生物体
动物	众生	百兽	动物群
温血动物	常温动物
冷血动物	变温动物
节肢动物	甲壳动物
线形动物	圆形动物
植物	植被
阳性植物	喜光植物
作物	农作物
大秋作物	晚秋作物	秋庄稼
越冬作物	过冬作物	冬作物
青苗	青
微生物	菌物
动植物	飞潜动植	野物
物品	品	物料
必需品	用品	日用品	消费品	日用百货
给养	补给
摆设	陈设
纪念品	纪念物	纪念	表记	留念	纪念币
奖品	奖
杂物	杂品	什物	生财	零七八碎
古物	老古董	骨董	古玩
遗物	旧物	手泽	吉光片羽
失物	遗
证物	信物
赝品	赝鼎	冒牌货	假货	假冒伪劣品
抵押品	当头	当	质
违禁品	禁制品	禁品	危禁品	违禁物品	禁药
赃物	赃	贼赃
易燃物品	易燃物
工件	作件	制件	铸件
部件	元件	构件	预制构件
备件	附件	配件	零配件	构配件
货物	商品	货	货色	货品
百货	小百货	杂货	广货	日杂	小商品
下脚货	残货	剔庄货	次货	便宜货	牺牲品	旧货	劣货	余货	散货
国货	国产货	国产品
进口货	来路货	洋货	外货	海货	外来货	舶来品	外国货	进口商品
冷货	冷冻货
私货	黑货	走私货	水货
优质品	优等品	原装货
产品	出品	成品	制品	活	必要产品
粗制品	半制品	半成品	坯料	毛坯
副品	次品	等外品	处理品	残品	劣质品	滞销品	剩余产品
仿制品	复制品
试用品	试制品	展销品	新品	传销商品
出产	物产
水产	渔产	海产
土产	土特产	土货	土特产品
器具	器物	用具	器	器械	家什	器材
器皿	容器	盛器
酒器	酒具
喷头	莲蓬头
锚	铁锚
电烙铁	烙铁
电熨斗	熨斗
消火栓	消防栓
设备	装置	配备	装备	装具	设施
物资	战略物资	军品	军资	生产资料
材料	料	材	材质	生料	质料
原料	原材料	原料药
香料	香	香精
生活资料	消费资料	生活必需品
柴米油盐	油盐酱醋	油盐酱醋柴
家具	家电	农机具	食具	燃气具	灶具
礼品	礼物	礼	赠品	赠礼	人情	人事	仪	赐	贶	礼盒	礼金	红包	赠物
贺礼	贺仪
薄礼	小意思	千里鹅毛	谢礼
聘礼	彩礼	财礼
贡品	贡
祭礼	赙仪
嫁妆	妆奁	妆	陪嫁	陪送
祭品	贡品	供	供品
宝物	宝贝	宝	珍	琛	珍品	珍宝	至宝	无价宝	瑰
宝	珍玩	奇珍异宝	麟角凤觜	吉光片羽	宝中之宝	金银财宝	无价之宝	财宝
宝藏	矿藏	富源	资源	宝库	聚宝盆	金矿
传家宝	家珍
废物	废料	废品	破烂	破铜烂铁	杂质	下脚	垃圾	渣滓	废弃物	滓	渣	污物	排泄物	污染源	垃圾堆
矿物	矿产	矿	矿体	矿物质
担子	挑子	担	货郎担
包裹	包袱	包	卷
它	她	其	它们
什么	甚	啥	哪	何	啥子	哪门子	甚么	何事
锭	砖
块	丁	疙瘩	硬结	块状
粉	粉末	面	面子	末	末子	屑	霜	齑粉	末儿	碎末
沙	沙子
点	点子	星	星子	花	一点
粒	豆子	砟子	砟	微粒	颗粒	球粒
堆	垛	坨	坨子	簇	垛子
把	把子	捆	束	卷	扎	一小撮	括
球	团	蛋	弹	珠	丸	丸子	圆子	弹子	珠子	圆珠
轮	饼
片	片子	板	皮	片儿	片片
箔	膜	衣	箔条
草屑	木屑	纸屑
筒	管	杆	筒子	管子
洞	窍	洞窟
棒	棍	鞭	尺	条	筋
焊条	焊丝
钩	钩子
鱼钩	渔钩
网	网络	络	纱	网子	大网	罗网	发网	台网
蜘蛛网	蛛网
波	浪	脉	波形
表面波	音波	冲击波	平面波	微波	纵波
顶	颠	峰	当	冠	梢头
端	头	颖	嘴	末	梢	尖	尖头	尖子	终端	先端	末流
鸡冠	鸡冠子
炕头	床头
底	根	脚	底边	底部	底层	底色	标底	最底层	平底	低点器底
末尾	末梢	末	梢	蒂	尾	尾巴	尾子	屁股
边	沿	缘	四边	斜边	沿儿
角	棱角	犄角	一角
面	面子	皮	脸	表	表面	面上
正	正面
外表	外边	外面	浮面	皮面	表层	表皮	浮皮儿	浮头儿	浅表
外壳	壳	壳子
反面	背面	里	背	阴	碑阴
侧面	侧	边
南侧	南端
东侧	东端
北侧	北端
外围	外层
脊	棱	梁	脊梁
身	体	干	筒
膛	腹	腔	胆
帮	壁
颈	脖
骨架	骨子	龙骨	骨	架	架子	骨头架子
框	框子	边框
盖	盖子	帽
塞	塞子
杆	梗	杆子	竿子	横杆	竿
柄	托
把	把手	把子	耳子	襻	把儿	靠手	提手	提梁	轩辕
拉手	扳手	摇手
刀把	刀柄
嘴	门	口腔
座	座子	底座	底盘	托	支座	托子	插座	灯座	宝座	礁盘	软座	假座
脚	腿	足	发射臂	秧脚	韵脚	脚蹼	凤爪	脚底
翼	翅	翅膀	翅子	侧翼	尾翼	双翼	翅翼	副翼	机翼
挡	栅	靶档
心	芯	芯子
宇宙	天体	星体	天地	六合	大自然	自然界	宏观世界	宇宙空间	宇	穹庐
星辰	星斗	星	星星	星球	星体	辰	繁星	双星	日月星辰
星座	座	宿	星宿	二十八宿
银河	天河	星河	河汉	银汉	云汉
金星	太白星	启明	长庚	昏星	晨星	启明星
火星	荧惑
木星	岁星
土星	镇星
织女星	织女
牵牛星	牵牛	牛郎星
北斗星	斗	天罡星	北斗
北极星	北辰
彗星	扫帚星	孛	哈雷彗星	白虎星
老人星	寿星
流星	贼星	客星	陨星	陨铁	陨石
太阳	阳	日	日头	红日
朝阳	旭	旭日	朝日
夕阳	斜阳	残阳	落日
骄阳	烈日	炎日	烈阳	艳阳	丽日
太阳黑子	黑子	日斑
月亮	月球	月	阴	太阴	嫦娥	玉兔	白兔	月宫	蟾宫	蟾蜍	婵娟	玉环	月儿
朔月	新月
新月	月牙
满月	望月	月轮
皎月	皓月	明月
日月	大明
地球	地	球
寰球	寰宇	寰
陆地	大陆	陆	洲	地	陆上	次大陆	新大陆	大洲	沂
冲	坳	山坳	山坞
低地	洼地	盆地	淤土地	低洼地
荒地	沙荒	荒野	荒原
生荒	生地	处女地
盐碱地	碱地	碱荒	荒碱地
雪域	雪地	雪峰	雪原
原野	旷野	田野	郊野	莽原	莽苍	沃野千里	圹
平原	平地	平川	坝子	沙场	一马平川	冲积平原	坪
草原	草地	甸子	草甸子	草野	科尔沁
淤地	沼泽	水泽	草泽	泽国	泽	沼	沼泽地
沙漠	漠	大漠	荒漠	戈壁
岛屿	岛	屿	渚	汀	坻
沙洲	三角洲	洲	沙地
滩	沙滩	碛	坝	沙嘴	滩头	摊床
岸	岸边	水边	滨	沿	湄	浔	矶	皋	岸上	坡岸	彼岸	对岸	河沿	近岸
山	山脊	山脉	山峰	岭	岩	群山	深山	山体	支脉
青山	苍山	翠微
高山	岳	山岳	山陵	崇山峻岭	小山	峻
山冈	山包	墚	冈	冈陵	冈峦	岗	岗子	土岗	山岗	突地
土山	丘	阜	土丘	土包	山丘	丘岗
峦	峰峦	山峦	叠嶂	山岭	丘陵	重峦叠嶂	层峦迭嶂	层峦叠嶂	群峰	冰峰	分水岭	长岭	峻岭	山川	山山岭岭	荒山野岭	荒山秃岭
山顶	山头	巅	峰	峰顶	顶峰	高峰	主峰	险峰	奇峰	山上	巅峰	岚山头
山脚	山麓	山根	麓	陬	山嘴	山下
山脊	山梁	山腰	山巅	半山区	半山腰
山谷	谷	壑	山沟	幽谷	峡谷	低谷	谷地	河谷	崖谷	深谷	峡	山峡	山沟沟	山凹	山里	底谷	空谷	狭谷	沟谷	谷底	塬谷	雪谷
山崖	崖	云崖	悬崖	峭壁	削壁	绝壁	悬崖峭壁	陡壁	涯
童山	秃岭	沙岭	荒岭
山间	山野
西北麓	北麓	南麓
坡	斜坡	坡坡	坂
山坡	阪
缓坡	慢坡
荒山坡	荒坡
海洋	大海	大洋	沧海	海洋	溟	瀛	海域	浅海	汪洋大海	深海
远洋	重洋
洋流	海流
大陆架	陆棚	陆架	大陆坡
内海	内陆海	陆海
濒海	海边	近海
江河	江	河	川	水	河流	水流	河川	长河	沧江	天堑	河水	江湖	江流	大江	沿河	河里	延河水	江河水	地表水	大溜	浊流	淮
小河	浜	河渠
护城河	城池	城壕	城隍
岔流	汊流	港汊	汊
主流	干流
支流	港
河床	河道	河槽	河身	主河道
河曲	流觞曲水
巨流	洪流
急流	激流	奔流
暗流	伏流	地下水
溪涧	山涧	溪流	涧	溪	溪水	小溪	细流
水沟	河沟	沟	沟渠	浊水溪	干支沟
湖泊	湖	海子	泖	淀	湖水
咸水湖	盐湖
池塘	池沼	池子	池	塘
粪池	化粪池
泥坑	泥潭	泥塘
潭	潭水	水潭
湖泽	湖沼
泉水	泉
喷泉	飞泉
温泉	汤泉
瀑布	飞瀑	瀑	玉龙
废墟	瓦砾	断垣残壁	残垣断壁	断井颓垣	断壁残垣	殷墟	堞s
雨	雨水	澍
雨点	雨脚	雨幕	雨滴	雨珠
小雨	毛毛雨	牛毛雨	烟雨	细雨	蒙蒙
大雨	豪雨	霈	倾盆大雨	滂沱大雨	瓢泼大雨
骤雨	暴雨	雨	暴风雨	雷暴雨	疾风暴雨	大暴雨	冰暴
阵雨	雷阵雨	雷雨	过云雨
霖雨	霖	淫雨	苦雨	淫
黄梅雨	梅雨	霉雨
喜雨	甘雨	及时雨	甘霖
雪	雪花	雪片	玉龙	鹅毛雪	冰雪	鹅毛大雪	飞雪	白雪
粒雪	雪球	碎雪	雪条
雹	冰雹	雹子	霰	风雹
冰	冰凌	凌
冰锥	冰柱	冰挂
冰块	冰碴	冰粒
大风	疾风	狂风	暴风	扶风
飓风	台风	强风	飚	强台风
微风	软风	轻风
清风	雄风
和风	熏风	暖风
寒风	阴风	冷风	朔风
热风	焚风
东风	谷风
南风	熏风
西风	大风
北风	凉风	朔风
西南风	凉风
逆风	打头风	顶风
旋风	羊角
信风	贸易风
狂风暴雨	暴风骤雨	疾风暴雨
凄风苦雨	苦雨凄风
过堂风	穿堂风
沙尘暴	沙暴
晚风	夜风
云	云彩	云朵	云块
云气	霭
阴云	彤云	云
彩云	云霞	雯	火烧云
庆云	祥云
露	露水	露珠	寒露
严霜	冷霜
虹	彩虹	鲎
副虹	霓	霓虹
霞	彤云	彩霞
烟	烟雾	云烟
雾	雾气	雾霭	氛
云雾	烟霭	暮霭	岚
雷	霹雳	霹雷	雷霆	霆	惊雷
炸雷	焦雷
闪电	电	银线	电闪
潮汛	潮信	潮水	潮汐	汐	潮	汛
流水	清流	水流	溜	湍	湍流	白煤
洪水	洪流	洪	暴洪	山洪	大水	洪峰
深渊	渊
积水	沥水
开水	滚水	白开水	白水	热水	汤	沸水	凉白开
生水	凉水	冷水
泔水	米泔水
水滴	水珠
培养液	营养液
春水	绿水
汁	汁液	汁水	液	水	液汁
浆	浆液	糊	糊糊
泡	泡沫	沫子	沫	沫儿	泡泡	白沫	水花
水泡	沤
卵泡	气泡	血泡	液泡
波浪	波	浪	浪头	浪花
大浪	澜	涛	怒涛	波涛	波澜	洪波	激浪	银山	惊涛骇浪	巨浪	浪涛	洪涛	涛澜	惊涛	波峰浪谷
涟漪	鳞波	漪
漩涡	涡流	涡	涡旋
野火	天火	燹
篝火	营火
磷火	鬼火
火焰	火苗	火头	火舌	火柱	火花	灯火	焰
外焰	氧化焰
内焰	还原焰	焰心
烈火	大火	活火	火海	烈焰
星火	微火	星星之火
烟火	焰火	火树银花
烽火	烽烟	狼烟	兵燹	战火	炮火	火网	烟尘	烽
光	光线	亮光	光明	光耀	光华	光芒	光焰	光辉	光泽	曜	光柱	强光	光饼	焱	辉
日光	阳光	太阳	晖	昱	烨	熹
曙光	晨光	晨曦	朝晖	晨晖	晨辉	曦
落照	残照	夕照	斜晖	余晖	夕晖	余辉
月光	月色	月华	蟾光
灯光	灯火
白炽	白热
红外线	红外光	热线
紫外线	紫外光	黑光	紫外
偏光	偏振光
影	影子	投影	阴影	暗影	黑影
人影儿	身影	身形	人影
背影	后影
电	电老虎
正电	阳电
负电	阴电
感生电流	感应电流
电波	电磁波
无线电波	高频电波
磁共振	核磁共振
气	气体
空气	大气
冷气	凉气	寒气	冷空气	寒潮	寒流	冷气团
暖气	热气	热浪	暑气	热流
氧气	氧
氢气	氢	重氢
氮气	氮
氯气	氯
氨气	氨	阿摩尼亚
碳酸气	碳酐	二氧化碳
沼气	甲烷
电石气	乙炔
毒气	毒瓦斯
水蒸气	蒸气	汽	水汽	蒸汽	水蒸汽
氩气	氩
氟化氢	氟利昂
颜色	色	彩	色彩	色泽	色调
淡色	素色
基色	原色	本色
冷色	寒色
补色	对比色
图案色	广告色
银灰	银灰色
气息	气味	气	味	味道	鼻息
味道	滋味	味	味儿
回味	余味
声音	声响	音响	响声	声息	响动	动静	声	音	响	涛	籁	声浪	鸣响
乐音	乐声	乐
噪音	噪声
回声	回响	回音
标准音	国音	正音	国语
元音	母音	韵头	韵腹
辅音	子音	复辅音
爆发音	破裂音
擦音	摩擦音
齿唇音	唇齿音
舌根音	舌面后音
翘舌音	卷舌音
字音	字	口齿
话音	口音	语音
方音	口音	土音	乡音
音节	音缀
叮当作响	叮当
足音	脚步声	跫然
喊叫声	叫声
赞扬声	喝彩声	赞叹声	叫好声
鞭炮声	爆竹声	礼炮声
问候声	祝福声
无息	无声无息
大声	高声	大嗓门
低声	悄声
音调	声调	腔调	调	调	调子	调	声腔	腔
字调	四声
阴平	第一声
阳平	第二声
上声	第三声
去声	第四声
节拍	拍子	板眼	板	点子	节奏	旋律	音频	韵律	辙口
灰尘	灰	灰土	尘埃	尘	纤尘	尘土	埃
灰烬	烬
浮土	浮尘	浮灰
征尘	风尘
烟尘	尘烟
污垢	污	垢	污秽	污浊	污痕	污点	龌龊	肮脏	垢污	污渍
泥垢	尘垢	油泥	皴
纹路	纹	纹理
皱纹	皱	襞	褶子	褶皱	皱褶	褶
指纹	螺纹	罗纹	指印	斗箕	脶
痕迹	印痕	印子	痕	迹	辙	皱痕	划痕
手印	手模
踪迹	踪	躅	行踪	行迹
足迹	脚印
血迹	血印	血渍	血痕
油迹	油渍
字迹	笔迹	墨迹
汗斑	汗碱	汗渍
点	点子	斑点
道子	道	道道
伤痕	创痕	伤疤	疤痕	节子
瘢痕	瘢	疤	疮疤	疤瘌
裂痕	裂璺	裂纹
车辙	轨辙
树木	树	木	花木	参天大树	椽	小树	大树
果树	果木
树林	林	森林	丛林	林海	老林	树丛	山林	林子	原始林	密林
树行子	林带
松林	松树	鱼鳞松	马尾松	迎客松	黄山松	古松	苍松	青松	罗汉松	落叶松	雪松	油松	偃松
海松	红松	赤松
杉	杉木
冷杉	枞	枞树
桧	刺柏	栝
毛白杨	响杨	白杨
柳	杨柳	垂柳	垂杨柳	柳树	柳木
河柳	旱柳
雪柳	稻树	过街柳	水曲柳
蒲柳	水杨
红柳	三春柳
梧桐	梧	桐
悬铃木	法国梧桐
香橼	枸橼
苏铁	铁树
椴树	河北杨
椴	菩提树	菩提
栗	板栗
楮	构
栎	柞树	柞	橡	橡树
槲栎	槲寄生
檀	青檀	檀木
棕榈	棕树	棕
三角枫	桠枫
枫	枫树	枫香树
降香	木香
棠梨	棠	杜
山桐子	椅
珙桐	空桐树
棘	酸枣树	枣树
洋槐	刺槐
泡桐	桐
枳	枸橘	金橘	桔树	越橘
荆	荆棘
橡胶树	橡
樟	樟木	樟树
杨树	小叶杨	银白杨	钻天杨	胡杨	黄杨	赤杨	青杨	钻天柳
翠柏丛	古柏	翠柏	苍松翠柏	桧柏	柏	柏树	侧柏	扁柏	松柏
榕树	高山榕
灌木	灌木丛	沙棘	灌丛	树莓
榆树	榔榆	榆叶梅	榆
娑罗树	娑罗双树
桦树	白桦树	桦
槐树	国槐	古槐	香樟	法桐	楠	槐	紫穗槐	龙爪槐
柳杉	南洋杉	枯杉	松杉	秃杉	红豆杉	水杉	铁杉	油杉	云杉	紫杉	红杉	杉篙
常青树	长青树	常绿树
椰林	椰树林
果木林	果林
幽林	林莽	险崖老林	杂花生树	次生林	残次林
栀	金栀
竹子	竹	篁	筠	筇	青竹	笋竹	筱	竺	篙
毛竹	南竹
观音竹	凤凰竹
紫竹	黑竹	墨竹
斑竹	湘妃竹	湘竹
箬竹	箬	笪
竹篾	篾青
竹笋	毛笋	春笋	冬笋	竹茹
花	葩	英	芳	花儿	群芳
牡丹	国花	国色天香	牡丹花
菊花	菊	黄花	秋菊
荷花	荷	莲	芙蓉	草芙蓉	莲花
兰花	兰	兰草	春兰	草兰
珠兰	金粟兰
睡莲	子午莲
唐菖蒲	剑兰
梅花	梅	花魁	玉骨冰肌
紫薇	满堂红
木兰	木笔	辛夷
木芙蓉	木莲	芙蓉
山茶	茶花	山茶花
合欢	马缨花
仙人球	仙人掌	仙人鞭
腊梅	黄梅
朱槿	扶桑
杜鹃	映山红
月季	月月红	月季花
丁香	紫丁香	丁香花
蔷薇	野蔷薇
凤仙花	指甲花
水仙花	凌波仙子
凌霄花	紫葳
紫茉莉	草茉莉
牵牛	喇叭花
翠菊	江西腊
大丽花	西番莲
油菜花	黄花
紫藤	藤萝
三色堇	蝴蝶花
天竺葵	洋绣球
百合花	百合
茉莉	茉莉花
鲜花丛	花海	花球	花丛
山丹丹花	山丹
郁金	郁金香
花卉	花草	唐花	花木
奇花异卉	名花异草	奇花异草
草	荐	卉
草丛	草莽	草甸
杂草	荒草	野草	丛杂
蓬	飞蓬
茅	白茅	茅草	茆
蒿子	蒿
沿阶草	绣墩草	蒲草
鹅观草	鹅冠草
青蒿	香蒿
藜	莱
浮萍	水萍	紫萍	红萍
爬墙虎	爬山虎
藻	海藻	水藻	藻类
海带	昆布
苔	青苔	苔藓	藓苔	苔衣
蕈	菌
银耳	白木耳
灵芝	紫芝	芝
香菇	香蕈
蘑菇	口蘑	蘑	菇	冬菇	春菇	莪
黑木耳	木耳
五谷	庄稼	谷物	粮食作物
稻	稻子	谷	谷子	稻谷	水稻	谷类
旱稻	陆稻
麦	麦子
小麦	麦	麦子
大麦	春大麦
冬麦	冬小麦
春麦	春小麦
元麦	青稞	稞麦	裸麦
玉米	玉蜀黍	老玉米	苞谷	苞米	珍珠米	棒子	棒头	粟米	包谷	玉茭	玉米粒	紫玉米
谷子	谷	禾	粟	稷	粟子	粱
黍子	黍	稷
高粱	秫	黍	黍	粱
糜子	糜
芡	鸡头
蔬菜	菜蔬	菜	蔬
青菜	小白菜
白菜	大白菜	菘
包心菜	卷心菜	洋白菜	结球甘蓝	圆白菜
球茎甘蓝	苤蓝	甘蓝
芥菜	芥	盖菜
花椰菜	花菜	菜花
油菜	菜
韭菜	韭	韭黄	韭芽
葱	大葱	小葱	水葱
洋葱	葱头
大葱	莞
大蒜	蒜	蒜头	青蒜	葫
香菜	芫荽
宝塔菜	草石蚕	甘露
巢菜	野豌豆	薇
金针菜	黄花菜	黄花
金花菜	黄花苜蓿
叶甜菜	牛皮菜
银条菜	银根菜	银苗
香椿	香椿头	香椿芽
萝卜	莱菔	菲	小萝卜	白萝卜	萝
胡萝卜	红萝卜
芜菁	蔓菁	葑
茭白	菰
莴苣	莴笋	笋子
芦笋	石刁柏	龙须菜
辣椒	辣子	番椒	柿子椒	灯笼椒	甜椒	青椒	山鸡椒	柿椒
番茄	西红柿
南瓜	番瓜	倭瓜
黄瓜	胡瓜
菜瓜	越瓜
豆	豆子	菽	豆瓣	豆类
大豆	毛豆	黄豆
蚕豆	胡豆
赤豆	赤小豆	小豆	红小豆
红豆	相思子
豆荚	豆角儿	豆角
菜豆	芸豆	四季豆	刀豆
芋	芋艿	芋头
薯	芋	薯类
甘薯	番薯	红薯	地瓜	山芋	白薯	芋头	木薯
马铃薯	土豆	山药蛋	洋芋
豆薯	地瓜	凉薯	苕子
菊芋	洋姜
慈姑	茨菰
藕	莲菜	莲藕	荷藕
大棚菜	棚菜
水果	果品	鲜果
瓜果	瓜
柚	柚子	文旦
橘	橘子	橘柑	蜜橘	桔	桔子	福橘
柑	柑子	蜜柑	柑橘	柑桔	金桔	蜜桔	金橘
橙	橙子	广柑	香橙	脐橙
荔枝	丹荔
石榴	榴
樱桃	樱	山樱桃
橄榄	青果
橄榄	洋橄榄	油橄榄
枣子	枣
黑枣	软枣
苹果	苹	柰	香蕉苹果
梨	梨子
草莓	草果	杨梅
菠萝蜜	凤梨	菠萝	黄菠萝
椰	椰子
杏	杏子	山杏
李	李子	李
猕猴桃	羊桃	杨桃	苌
五敛子	羊桃	杨桃
番木瓜	木瓜
葡萄	葡	萄	野葡萄
核桃	胡桃
山核桃	小胡桃
榧	香榧	香榧子	榧子
桃	桃子
蟠桃	扁桃
椰枣	海枣
桂圆	龙眼
柿	柿子	油柿
香蕉	甘蕉
花红	沙果
草果	草豆蔻
肉豆蔻	肉果
银杏	白果
香橼	枸橼
榛	榛子
杜梨	棠梨
栗子	栗	板栗
甜瓜	香瓜	哈蜜瓜	哈密瓜
甜枣	蜜枣
药草	药材	中草药	草药	中药材
川芎	当归
萝芙木	蛇根草
大蓟	蓟
龙牙草	仙鹤草
木豆	豆蓉
乌梅	酸梅
南天竹	天竹
贝母	川贝
肉苁蓉	苁蓉
苁蓉	列当
生地	生地黄
熟地	熟地黄
麦门冬	麦冬
蒺藜	茨
人参	参	西洋参	高丽参	丹参	党参	红参	苦参	沙参	太子参	土党参	玄参	长白参	洋参
酒花	啤酒花	蛇麻
鱼腥草	蕺
忍冬	金银花
马齿苋	长寿菜
川军	大黄	将军
芸香	芸
高根	古柯
钩吻	野葛	葫蔓藤
茱萸	山茱萸	吴茱萸	食茱萸
肉桂	桂
枸杞	枸杞子
经济作物	技术作物
落花生	花生	长生果	仁果	水花生
油菜	菜	薹
芝麻	麻
向日葵	葵花	朝阳花	向阳花	葵
蓖麻	大麻子
油瓜	油渣果	猪油果
油棕	油椰子
白苏	荏
油桐	桐油树	桐
桉树	桉	玉树	黄金树	有加利
大茴香	八角茴香	八角	大料
桂皮	桂	桂皮树
甘蔗	蔗
甜菜	糖萝卜
海枣	枣椰
蓼蓝	蓝
茜草	茜
红花草	紫云英
苜蓿	紫花苜蓿
稗子	稗
茶	茶树	毛茶
棉花	棉	草棉
木棉	红棉
桑	桑树
麻	蕉
大麻	线麻
种麻	苴麻
苘麻	青麻
罗布麻	茶叶花
马尼拉麻	蕉麻
芨芨草	枳机草
白藤	红藤
狼尾草	草	稂
芦苇	苇	苇子	芦	芩	葭
马兰	马蔺	马莲
龙须草	蓑衣草
国产棉	国棉
上棉	优质棉
白色棉	白棉
彩棉	彩色棉
植株	株
病株	劣株
茎	本	干	梗
秆	秆子	秫秸	棵子	萁	秸	穰	稿	莛
藤	藤子	蔓	藤蔓	藤条	蔓儿
树干	树身	株	干
花茎	画轴	花梗
蒜薹	蒜苗
茬	蔸
麦茬	麦秸	秸秆
枝	枝子	枝条	侧枝	条	柯	枝干	主枝
枝桠	枝杈	杈子	杈	桠杈	树杈	丫杈	枝丫
蘖	蘖枝
疯枝	疯杈
树梢	杪	标	梢头	树冠	枝头
柳丝	柳枝
根	根子
树根	柢	根须
叶	叶子	叶片	箬	藿	菜叶	桑叶	树叶	霜叶
枫叶	红叶
花朵	朵儿	花	繁花
花蕾	蕾	蓓蕾	花骨朵	骨朵儿	骨朵	蓓
筒状花	管状花
花瓣	瓣	花瓣儿
花萼	萼片
花蕊	蕊	花轴
花苞	苞
花茎	画轴
芽	胚芽	荑	嫩芽	萌
侧芽	腋芽
叶芽	叶芽儿
苗	秧	栽	苗子	幼苗	秧苗	秧子	栽子	幼株	苗木	小苗
母株	母本
柄	把
果实	果子	果	实
梅子	青梅	黄梅	梅
桑果	桑葚
菱角	菱	芰
荸荠	地梨	马蹄
果皮	中果皮	外果皮
核	内果皮	核儿
瓤	瓤子	肉	果肉	沙瓤
种子	子实	子粒	种	籽	子	实	粒	米	籽儿	籽粒
仁	种仁
松仁	松子
花生米	花生仁
莲子	莲蓬子儿
油菜子	菜子
芡实	鸡头米
草籽	草种
葵花子	葵花仁
牲畜	畜	家畜	六畜	畜生	三牲
役畜	力畜
牲口	饩
子畜	幼畜	崽	崽子	娃	娃子
牺牲	牲	牢
野兽	兽	走兽
猛兽	貔貅	貔	豺狼虎豹	熊	罴
狼獾	貂熊
海熊	腽肭兽	海狗	海狮
熊猫	猫熊	大熊猫	大猫熊
小熊猫	小猫熊
犀	犀牛
獾	狗獾
猪獾	沙獾	猸子
箭猪	豪猪
刺猬	猬
貉	貉子	狸
豹猫	山猫	狸猫	狸	狸子
河狸	海狸鼠
紫貂	黑貂
黄鼠狼	黄鼬	貔子
猞猁	林
穿山甲	鲮鲤
蝙蝠	蝠
狮	狮子	兽王
虎	老虎	大虫	於
幼虎	乳虎	虎子	虎崽	虎仔
豹	豹子	金钱豹
象	大象
猛犸	毛象
狗熊	黑熊	黑瞎子
马熊	棕熊	罴
白熊	北极熊
狼	狼群
狐	狐狸
赤狐	火狐	红狐	火狐狸
玄狐	银狐
白狐	北极狐
草狐	花面狸
猩猩	猩
猴子	猴	猕猴	猢狲	山魈
鹿	麈	鹿群
麋	四不象	麋鹿
狍子	狍
马鹿	水鹿
麂	麂子
獐	獐子
骆驼	驼
马	马匹	马儿
儿马	驹
母马	骒马	牝马
骏马	高足	骜	骏	骥	驵	千里马	千里驹	高头大马
驽马	劣马	驽	蹇	骀
骢	骓
马驹子	驹子	马驹
驴	驴子	毛驴
公驴	叫驴
骡子	骡	马骡	驴骡
牛	牛群
公牛	牯牛	牡牛	犍牛
母牛	牛
奶牛	乳牛
耕牛	犁牛
小牛	犊	牛犊
羚羊	扭角羚
羊	羊群
公羊	羝	羯
羊羔	羔羊	羔子	羔	羊崽
头羊	带头羊
羚羊	羚	剑羚
石羊	岩羊
猪	猪猡	豕	豚
毛猪	生猪	活猪
猪仔	豚	仔猪	猪苗	猪娃
狗	犬	獒
猎狗	猎犬	猃
哈巴狗	巴儿狗	狮子狗	叭儿狗
兔	兔子
野兔	野猫
鼠	老鼠	耗子
小家鼠	鼷鼠
褐家鼠	大家鼠	沟鼠
豚鼠	天竺鼠
鼹鼠	鼹
黄鼠	大眼贼
松鼠	灰鼠
鳄鱼	鳄
扬子鳄	猪婆龙
鲸鱼	鲸
海豚	海猪
江豚	江猪
人鱼	儒艮
蛇	长虫	群蛇
蟒蛇	蟒	蚺蛇	巨蟒
五步蛇	白花蛇
水蛇	青蛇
蛙	青蛙	田鸡	蛤	蝌蚪	蛤蟆
蟾蜍	癞蛤蟆	疥蛤蟆
蜥蜴	四脚蛇
獭	水獭	海狸
海獭	海龙
禽兽	鸟兽	飞走	飞禽走兽	兽类
禽	鸟	飞禽	雏鸟	鸟类	鸟儿	小鸟	鸟雀	鸟群
猛禽	鸷鸟
隼	鹘
练鹊	绶带鸟
鹌鹑	鹑
猫头鹰	夜猫子	鸱鸺
鸵鸟	鸵
大鸨	鸨
鹭	鹭鸶	白鹭
鹗	鱼鹰
鸿雁	鸿	雁	大雁	头雁
雉	野鸡	山鸡	翟
吐绶鸡	火鸡
野鸭	绿头鸭
天鹅	鹄	鸿鹄	大天鹅
乌鸦	乌	老鸹	老鸦	寒鸦	鸦
燕	燕子	家燕	雏燕	小燕子	燕儿
几维鸟	无翼鸟
鹈鹕	淘河
极乐鸟	风鸟
喜鹊	鹊
朱顶	贮点红
八哥儿	鸲鹆	八哥
鸬鹚	鱼鹰	墨鸦
黄鹂	黄莺
鹦鹉	鹦哥	绿衣使者
杜鹃	布谷	子规
戴胜	山和尚	呼
鹁鸪	水鸪鸪
鲲鹏	鹏
禽畜	畜禽
鹰	老鹰	鸢	苍鹰	雏鹰	雄鹰
雀鹰	鹞子	鹞鹰	鹞	鸱
秃鹫	坐山雕	兀鹫
雕	鹫
雀	麻雀	嘉宾
金丝雀	黄鸟
鸽	鸽子
家鸽	鹁鸽
野鸽	原鸽
乳鸽	白鸽
仙鹤	白鹤	丹顶鹤
海鸥	海燕
鸡	家鸡
公鸡	雄鸡
母鸡	草鸡	牝鸡
小鸡	角雉	雏鸡
笋鸡	童子鸡
鸭	鸭子	家鸭	鹜
鹅	菜鹅
鱼	鲜鱼	鱼儿	鱼群	鱼类
鱼苗	鱼秧	鱼花	鱼秧子	鱼种
淡水鱼	河鱼
青鱼	黑鲩
草鱼	鲩
鲫	鲫鱼
鳜	鳜鱼
鲢	白鲢
鲟	鲟鱼	鲔
鲤	鲤鱼
鳙	鳙鱼	胖头鱼
鲥	鲥鱼
鳊	鳊鱼	武昌鱼
乌鳢	乌鱼	黑鱼
鳅	泥鳅
黄鳝	鳝鱼	鳝
黄鱼	黄花鱼	石首鱼	大黄鱼	小黄鱼
乌贼	墨鱼	墨斗鱼
鳓	鳓鱼	快鱼	白鳞鱼
鲳	鲳鱼	银鲳	平鱼
柔鱼	鱿鱼
章鱼	八带鱼
比目鱼	偏口鱼
鲨鱼	鲛	鲨
鳗鲡	鳗	白鳝	白鳗	鳗鱼
大鲵	娃娃鱼	鲵	小鲵
大麻哈鱼	大马哈鱼	鲑鱼
鳕	鳘	大头鱼
鲚	凤尾鱼
真鲷	加级鱼
鲅	蓝点鲅	燕鱼	马鲛鱼
海龙	杨枝鱼
鳎	鳎目鱼	条鳎	舌鳎
鳟	鳟鱼
鲈	鲈鱼
鱼虾	水族	鳞甲
龟	乌龟	金龟	王八	幼龟
鳖	鼋	甲鱼	鼋鱼	团鱼	王八	田鳖	鳌	鳖精
蟹	螃蟹	河蟹
梭子蟹	蝤蛑
寄生蟹	寄居蟹
虾	虾子
对虾	明虾	大虾
蚌	河蚌
蛤蜊	文蛤	蛤	蜊	蜃
贻贝	壳菜	淡菜	贝	贝类
牡蛎	海蛎子
蚶子	蚶	瓦垄子	瓦楞子
螺	螺蛳
海参	刺参
鲍鱼	鳆	石决明
海蜇	蜇	海蜇头	海蜇皮
昆虫	虫	虫子
蛀虫	蛀
幼虫	毛蚴	尾蚴	水虿
蟋蟀	蛐蛐儿	促织	蛐蛐
蟑螂	蜚蠊
螳螂	刀螂	螳
花媳妇	花大姐
蚯蚓	曲蟮
蝼蛄	蛞蝼	蝼
鲎虫	水鳖子
萤	萤火虫
蝉	知了	寒蝉	蜩	螗
衣鱼	纸鱼
地蚕	地老虎	土蚕
蛴螬	土蚕	地蚕	核桃虫
水蛭	蛭	蚂蟥	马鳖
松毛虫	松虎
毛虫	毛毛虫
叩头虫	磕头虫
蜈蚣	蚰蜒
星毛虫	梨狗
白蜡虫	蜡虫
星虫	沙虫
黏虫	剃枝虫
钻心虫	蛀心虫
壁虎	蝎虎
蠹	蠹虫
蝎子	蝎
蜗牛	水牛儿	蜗
绦虫	寸白虫
肝蛭	肝吸虫
蛤蚧	蛏子
蜂	蜜蜂
蜂王	母蜂
马蜂	胡蜂	黄蜂
蚕	家蚕	桑蚕	蚕宝宝
蚕蚁	蚁蚕
蚕茧	茧子
蝶	蝴蝶	胡蝶
蛾	蛾子	飞蛾
卷叶蛾	卷叶虫
蜘蛛	蛛蛛	蛛
棉红蜘蛛	红蜘蛛	火龙
蝗虫	蚂蚱	蝗	蚱蜢
蝗蝻	跳蝻	蝻子	蝻
螟虫	螟
蚜虫	蚜	腻虫
棉蚜	棉蚜虫
麦蚜	麦蚜虫
蚊	蚊子
库蚊	家蚊
按蚊	疟蚊
伊蚊	黑斑蚊
孑孓	跟头虫
蚊蝇	蚊虫
蝇	苍蝇	蝇子
蚁	蚂蚁	蚍蜉
臭虫	壁虱
跳蚤	虼蚤	蚤	跳虫
水蚤	鱼虫	金鱼虫
虱	虱子
蜱	壁虱
细菌	菌
根瘤菌	固氮菌
抗体	抗原
菌种	菌苗
病菌	病原菌	致病菌	毒菌
病原体	病原
酵母菌	酵母	酿母菌
霉菌	霉	黑霉	毛	曲霉
醭	白醭
身体	肢体	体	身	躯	躯体	肌体	肉体	肉身	身子	身躯	躯干	臭皮囊	人体	人身	血肉之躯	真身
形体	形骸	躯壳
全身	浑身	一身	通身	满身	周身	遍体
上体	上身	上半身
下体	下身	下半身
尸体	尸首	尸身	死尸	僵尸	死人	异物	遗体	遗骸	尸	殍
尸蜡	木乃伊
尸骨	尸骸	骷髅	枯骨	白骨	骸骨	髑髅	残骸	遗骨
遇难者	丧生者	死者
头	首	头颅	脑袋	脑瓜子	脑瓜儿	脑壳	首级	脑瓜	脑部	脑袋瓜	头部	满头
白头	皓首
额	前额	额头	脑门子	颡	天庭	天门	脑门	脑门儿
头顶	颠
秃顶	光头	谢顶
脑勺子	后脑勺子	后脑勺
脸	脸盘儿	脸面	面庞	面孔	面	颜	颜面	面部	人脸	满脸	脸部
颊	面颊	脸蛋儿	脸上	脸蛋	脸颊	脸孔	脸盘	脸庞	脸膛
颏	下巴	下颌	下巴颏儿	颔	颐
腮	腮帮子	腮颊
酒窝	笑靥	靥	笑窝
脑	脑子	脑髓	人脑
颅	颅脑	脑颅	颅腔	脑室
脑上体	松果腺	松果体
垂体	脑下垂体	脑垂体
大脑皮层	皮层	皮质
眼	眼睛	目	眸子	肉眼	双目	双眼	双眸	眼眸
秋波	秋水
老视眼	老花眼	花眼
眼球	眼珠子	睛	黑眼珠	眼珠
眼白	白眼珠
眼眶	眼圈	眶	眼窝
眦	眼角
眼里	眼底
晶状体	水晶体
虹膜	虹彩
结膜	结合膜
视网膜	网膜
瞳孔	瞳	瞳仁	瞳人	眸子	眸
眼角膜	泪膜
耳	耳朵	耳根
中耳	鼓室
内耳	迷路
外耳门	耳孔	外耳
耳垂	耳朵垂
外听道	外耳道
鼓膜	耳鼓
耳轮	耳郭	耳屏
鼻	鼻子	鼻头
酒渣鼻	酒糟鼻
鼻孔	鼻腔
口	嘴	颌	咀	喙	嘴巴	唇吻	满嘴
吻	口器	口吻	口腕
唇	嘴唇	吻	嘴皮子
兔唇	唇裂	豁嘴	缺嘴
嘴角	口角
舌头	舌	口条
腭	上膛
喉	喉头
咽喉	喉咙	嗓子	嗓	吭	嗓子眼	声门	喉管	嗓门
喉结	结喉
小舌	悬雍垂
咽	咽头
扁桃腺	扁桃体
上颌	上颚
下颌	下巴	下颚
声带	音带
牙	牙齿	齿
乳齿	奶牙
齿龈	牙龈	龈	牙床	牙花
臼齿	大牙	槽牙	板牙
智齿	智牙
门齿	门牙	大牙	板牙
犬齿	犬牙	虎牙
龋齿	蛀齿	虫牙	虫吃牙
釉质	珐琅质	珐琅
颈	头颈	颈项	脖子	脖	领	颈部
脖颈儿	项	脖颈
肩	肩膀	肩胛	肩头	双肩
胸	胸臆	胸膛	膺
胸脯	脯	胸口
胸腔	腔
怀	怀抱	怀里
心口	胸口	心坎	心窝儿	心里
乳房	乳	奶	奶子	胸部
乳头	奶头
背	背脊	脊背	脊梁	脊	背部	后背
腰	腰眼	腰杆子	腰板儿	腰板	腰部	腰杆	腰肢	后腰
腹	腹部	肚子	肚皮	肚	腹腔	腹内
小腹	小肚子
肚脐	脐	肚脐眼
臀	臀部	屁股	腚	尻	臀尖
四肢	肢
臂	胳膊	胳臂	臂膀	臂膊	膀子	膀臂	膀	肱	膊	前肢	手臂	双臂	上肢
上臂	膀子	膀臂	臂	前臂
腋	胳肢窝	腋窝	腋下	胳肢
肘	肘子	肘部	胳膊肘	手肘	肘窝
手	两手	双手
手掌	巴掌	手板	掌
掌心	手心	手掌心
拳	拳头
腕	腕子	手腕	手腕子	胳膊腕子	胳膊腕子	臂腕
寸口	尺中	关上	关	尺	寸
手指	手指头	指	指头	指尖
大拇指	拇指	大指	巨擘	拇	擘
二拇指	食指
三拇指	中指	将指	中拇指
小拇指	小指
猪手	猪爪
腿	下肢	后肢
腹股沟	鼠蹊
大腿	股	髀
膝	膝盖	膝头
小腿	胫
腿肚子	腓
腿腕子	脚腕子	脚脖子
胯	裆部
脚	脚丫子	足	趾	脚丫
小脚	金莲
扁平足	平足
赤脚	光脚板子
脚爪	爪子	爪儿	爪	爪部
脚趾	趾	脚指头	趾头	小趾
脚跟	脚后跟	跟	踵	后跟
脚掌	脚板	脚底板	跖	蹯	掌	足掌
脚面	跗面
脚背	跗
蹄子	蹄
角	犄角
鹿茸	茸
羚角	羚羊角
触角	触须	须子	须	触手	卷须
尾	尾巴	尾部
鳍	划水
脊鳍	背鳍
翼	翅膀	膀子	翅	膀	翮	羽翅	外翼	翎翅
鞘翅	翅鞘
皮肤	皮	肤	皮层	肌肤
表皮	浮皮	面皮	外皮
眼皮	眼睑	睑	眼帘	眼泡
肌肉	肌	筋肉	腠
横纹肌	随意肌	骨骼肌
平滑肌	不随意肌
腱	肌腱	筋腱	腱鞘	腱子
脂肪	脂	油	膏	脂膏	膏腴	膘
寒毛	汗毛
绒毛	绒	毳	茸毛	毛绒
纤毛	毫
马鬃	鬣	鬃毛	鬃
羽毛	羽	翎	翎毛	毛	羽绒
毛毡	毡
发	头发	髫	毛发	发丝
黑发	乌发
小辫儿	发辫	辫子	小辫	独辫　辫
青丝	乌云
发髻	髻	鬏	纂
鬓	鬓角	鬓发	两鬓	鬓毛
髦	刘海
华发	宣发	银发
胎发	胎毛	奶毛
眉毛	眉	眼眉
娥眉	柳眉	柳叶眉	黛
眉心	印堂
睫毛	眼睫毛	睫
胡子	胡须	髯	须
络腮胡子	连鬓胡子
骨骼	骨头架子
骨	骨头
骨骺	骺
头骨	颅骨	头盖骨	枕骨	顶骨
颧骨	眉棱骨
肩胛骨	胛骨	琵琶骨	锁骨
椎骨	脊椎骨	椎
颈椎	胸椎
脊	脊骨	脊梁骨	脊柱	膂	脊椎	脊索
胸骨	龙骨	腔骨
肋骨	肋巴骨	肋条	骨干
髋骨	胯骨
髂骨	肠骨
骶骨	荐骨
股骨	髀	股骨头
髌骨	髌	膝盖骨	膝关节
骨节	关节	骱
椎间盘	腰椎
指甲	甲	指甲盖
趾甲	脚指甲	爪
甲壳	甲	壳	介	厣	盖	盖子	壳子	硬壳
贝壳	介壳	蠡
鳞	鱼鳞	鳞片	鳞屑
内脏	脏器	脏腑	脏	内
器官	官	器
五脏	五中	五内	五脏六腑
肝	肝脏	肝部
脾	脾脏
肾	肾脏	腰子	肾盂
胰	胰腺	胰子	胰岛
胆	胆囊	苦胆
肫	胗
鳔	鱼鳔	鱼胶
感官	感觉器官
气管	呼吸道	上呼吸道	支气管
食管	食道
输尿管	尿道	泌尿器
肛管	肛道
肛门	肛
心	心脏
肺	肺脏	肺部
胃	肚子	胃部
肠胃	胃肠
肠	肠子	肠管	肠道
生殖器	性器官
阴茎	小便	阳	势
睾丸	外肾	精巢
阴部	阴户	阴	阴门	产门	下身	下体	产道
阴道	膣
子宫颈	宫颈
胎	胎儿	胚胎
衣胞	胞衣	胎衣	胎膜	羊膜	紫河车	衣	胞
胚盘	胎盘
娘胎	胞胎
经络	经脉	经
脉	脉络
血脉	血管
毛细管	毛细血管	微血管
大动脉	主动脉
动脉弓	主动脉弓
静脉	青筋	筋	筋脉	筋络
穴道	穴位	穴	腧
脉搏	脉息
骨髓	髓
神经原	神经细胞	神经元
传出神经	运动神经
传入神经	感觉神经
核子	细胞核
腺	腺体
淋巴腺	淋巴结
肾上腺	副肾
前列腺	摄护腺
胸膜	肋膜
横膈膜	膈	膈膜
瓣膜	瓣	活瓣
血液	血	血水	血流
潜血	隐血
血淋淋	血丝乎拉
抗毒血清	抗菌血清
淋巴	淋巴液
激素	荷尔蒙
汗	津	汗液	汗珠子	汗水	汗珠
痰	饮
唾液	唾	唾沫	吐沫	津液	口水	涎水	涎	津	哈喇子
奶水	乳汁	奶	乳	母乳	奶品
体液	津液	组织液
胃酸	胃液
月经	经血	经	血	精血
眼泪	泪液	泪水	泪珠	泪花	泪	涕
鼻涕	涕	泗
耳屎	耳垢	耳塞	耵聍
眼屎	眵	眼眵
头皮屑	头皮	头发屑
屎	矢	粪	便	粪便	大粪	大便
溏便	稀
尿	小便
精液	精	鱼白
精子	精虫	精
卵	子	卵子	卵细胞	卵块
蛋	卵
鸡蛋	果儿
鸭蛋	鸭子儿
蛋黄	卵黄	鸡蛋黄
蛋白	卵白	蛋清
五金	金属	大五金	小五金
铂	白金
锡	焊锡
铝	钢精
金银	金银箔
金	金子	黄金
足金	赤金	纯金	鎏
银	银子	白银	纹银	白金	足银
铜	黄铜	铜材
紫铜	红铜
铜线	铜丝
铝型材	铝材
钢	钢铁	钢材
硅钢	矽钢
角钢	角铁	三角铁
钢轨	铁轨
钢筋	钢骨	铁筋
钢水	铁水	铁流
铁	黑金
生铁	铸铁	铣铁
熟铁	锻铁
灰口铁	灰铁
磁铁	磁石	吸铁石
镀锌铁	铅铁	白铁	洋铁	铁皮	白铁皮
镀锡铁	马口铁	洋铁	铁皮
木料	木头	木材	木	原木
枕木	道木
软木	软硬木	栓皮
石	石头	石块	石碴
闪石	角闪石
燧石	火石
萤石	氟石
木化石	木变石
钟乳石	石钟乳
岩石	岩	岩层
磐石	盘石	磐	巨石
礁石	礁	暗礁	岛礁
卵石	河卵石	鹅卵石
矸石	矸子
石头子儿	砾	砾石	石子	石子儿
他山石	他山之石	它山之石	山石
土	土壤	壤	泥土	土体
土堆	土牛	墩
土块	坷拉	垡	土疙瘩	坷垃	团粒
黑土	黑钙土
黏土	埴	泥土	粘土	耐火黏土	熟料
高岭土	陶土	瓷土
泥	泥巴
烂泥	稀	泥	稀泥
沙	砂	沙子	砂子	砂石	型砂	砂砾	沙砾	砂礓
沙包	沙丘	沙山	沙峰	沙柱
水泥	洋灰	士敏土	水门汀	加气水泥	水泥块
混凝土	砼
三合土	三和土
灰浆	砂浆
石灰	白灰	灰	生石灰	活石灰	煅石灰
熟石灰	消石灰
沥青	地沥青	柏油	土沥青	木焦油
石膏	生石膏	熟石膏
砖	砖头	甓	砖块	砖石
碎砖	砖头	残砖碎瓦
耐火砖	火砖
瓦	瓦片	瓦块
小青瓦	蝴蝶瓦
瓦垄	瓦楞
板	板子	板材	板坯
挡板	隔板
图板	画板	画夹
管	管子	管材
陶管	缸管
煤	煤炭	乌金
无烟煤	硬煤	红煤	白煤
焦煤	主焦煤
煤砖	蜂窝煤
褐煤	褐炭
炭	木炭
草炭	草煤
泥炭	泥煤
焦炭	焦
木柴	柴火	柴	薪	芦柴	柴禾	干柴
火煤	火捻
松明	明子
煤油	火油	洋油
石油	原油
酒精	乙醇
润滑油	滑润油
凡士林	矿脂
颜料	颜色	水彩
红土	铁丹
蓝靛	靛青	靛蓝
油漆	漆	漆片	漆膜
蚕丝	丝	茧丝
生丝	绡
棉纱	纱	棉纤维
化学纤维	化纤
锦纶	尼龙
涤纶	的确良
皮革	皮子	革	皮	韦	皮张
毛皮	皮桶子	皮毛
胶	胶乳	溶胶	乳胶
鳔胶	鳔	鱼胶
石花胶	洋菜	洋粉	琼脂
橡胶	皮	胶
硫化橡胶	胶皮	橡皮
粘合剂	黏合剂
玻璃	玻
毛玻璃	磨砂玻璃
有机玻璃	不碎玻璃
釉	釉料	釉子
色釉	彩釉
珍珠	真珠	珠子	珠	串珠
佛珠	念珠
玉石	玉	璧	玉佩	佩玉
宝玉	美玉	琳
象牙	牙	象牙片
金刚钻	金刚石	钻	钻石
赛璐珞	假象牙	化学
吡	吡啶	有机化学
搪瓷	洋瓷
电木	酚醛	塑料	酚醛塑料	塑
肥料	肥
化学肥料	化肥
肥田粉	粒肥
颗粒肥料	粒肥
基肥	底肥	底粪
厩肥	圈肥
油饼	枯饼	油枯
尿素	脲
氨水	氢氧化铵
复合肥	复合肥料
有机肥	有机肥料
建筑	建筑物	构筑物
房屋	房子	屋宇	房	屋	房舍
住房	住宅	宅子	宅院	居室	庐舍	宅	斋	宅邸	庐
楼房	大楼	楼台	楼宇	楼	楼堂馆所	平地楼台	楼群	楼面	楼层
城楼	箭楼	角楼
鼓楼	钟楼	谯楼	塔楼
大厦	高楼	摩天楼	高楼大厦	摩天大楼	摩天大厦	巨厦	厦
广厦	深宅大院
宫殿	宫	殿
红楼	雕梁画栋	亭台楼阁	亭台楼榭
小屋	蜗居	寮	斗室
草屋	茅屋	茅舍	茅庐	草堂	庵	蓬门荜户	草房	草棚	茅棚	茅草屋
棚子	棚	厂
窑	窑洞
故居	故宅	旧居	旧宅	老宅	祖居	古堡
商业楼	商住楼	商品房	商客居
民居	民宅	家宅	私宅
居民楼	单元楼	住宅楼	住宅房	家属楼
危楼	危房	危旧房	危陋平房	拆迁房
城堡	城建	堡	坞
茅草房	草房子
别墅	山庄
公馆	官邸	私邸	府第	府邸	府	宅第
房间	屋子	室	间	房	房室
里屋	里间
外屋	外间
卧室	卧房	寝室	内室	起居室
厅	大厅	正厅	厅堂	客厅	厅房	客堂	会客室	厅子	宴会厅
饭厅	餐厅	食堂	饭堂	餐房
正房	上房	堂屋
厢房	厢	包厢
厨房	灶间	灶	庖厨	伙房	厨
厕所	厕所间	厕	便所	茅坑	茅厕	茅房	洗手间
卫生间	盥洗室	更衣室
门房	传达室
书房	书斋	书屋
教室	讲堂
藏书室	藏书楼	图书馆
录音室	录音棚
地下室	地窨子	地窖	窖
新房	洞房
闺房	闺阁	深闺	绣房	内宅	阃
公堂	大堂	堂	大会堂
会客厅	接待厅
展室	展厅
单间儿	单间
影厅	电影厅	录像厅	放像厅	演播厅
门	门户	闼	户	阖
旁门	侧门	边门	角门	脚门
宫门	阍
阎	闾
柴门	柴扉
门扇	扉
门闩	闩	扃	钌铞儿
门环	兽环
门槛	门坎
窗	窗子	窗户	轩	牖	窗扇	窗牖
窗台	窗沿
窗框	窗棂
门窗	窗门
门面	门脸
地基	基础	根脚	根基	地脚
地面	地
天花板	藻井
梁	檩	桁	檩子	椽子	栾
正梁	脊檩	大梁	栋	屋脊	屋梁	房梁
柱	柱子	柱头	支柱	柱身
桩子	桩
墙壁	墙	壁	垣	堵
城墙	城垣	城郭	关厢	城厢	城	墉	城垛
箭垛子	雉堞
照壁	照墙	影壁	萧墙
夹层墙	夹墙	夹壁墙
山墙	房山
防火墙	风火墙	挡风墙
围墙	墙围子	围子
隔断	隔扇
残墙断壁	断壁
长城	万里长城
篱笆	篱	藩篱	樊篱	篱落	笆篱	绿篱	花障	篱墙
栅栏	栅	篱栅
屋檐	房檐	雨搭
檐	檐子
水溜	檐沟	天沟	水落管	雨水管
排水沟	沟	下水道	排污沟
阳沟	明沟
阴沟	暗沟	渗沟
阳台	平台	晒台	凉台	楼台
院子	院落	天井	庭	庭院	小院
走廊	廊	廊子	过道	走道	甬道
台阶	踏步	阶	级	砌	除	墀	陛	坎	阶级	坎儿	坎子
石级	石阶	石坎	磴	阶石
楼梯	梯	阶梯	梯子
绳梯	软梯
栏杆	阑干	槛	栏
路	道
马路	街道	街	大街	逵
人行道	便道	走道	便路
胡同	弄堂	里弄	闾巷	巷	巷子	街巷
小街	小巷
桥	桥梁	大桥	圯
悬索桥	吊桥	索桥
开合桥	活动桥
旱桥	天桥
过街桥	过街天桥
田地	土地	田亩	田	大田	地	庄稼地	田畴	畴	农田	耕地	粮田
良田	肥田	高产田	米粮川	沃土	沃野	沃田
休耕地	休闲地	白地
旱地	旱田
水地	水田
承包田	承包地
田间	田里
熟荒	废耕地
田埂	埂子	阡陌	阡	陌	埝	垄	田垄	塄
园圃	园	园子	园田	圃	田园	庭园
温室	暖房	花房	大棚	温室群	暖棚	保暖棚	温棚
苗床	温床	冷床	阳畦
圈	栏	牢	囿	苑	栊	厩	栈	舍	棚	棚圈
猪圈	猪舍
马厩	马棚
笼	柙	槛
窠	窝	埘	巢	窝巢	窝窝
蜂巢	蜂窝
鸟窝	鸟巢
陷阱	陷坑	阱
水库	蓄水池	塘堰	塘坝
堤坝	水坝	坝子	堤岸	堤防	坝	堤	防	防水坝	堤堰	大坝	堤坡	堤围	岸防	坪坝	涝坝	拱坝	海堤坝	拦海大坝	河坝	河堤	大堤	堤埂
圩子	圩垸	子埝	垸	圩
水闸	闸	斗门	闸门	闸室
沟渠	沟	渠	渠道	水道	水渠	地沟	沟槽	渡槽	垄沟
沟沟壑壑	千山万壑	沟沟坎坎	沟壑
井	水井
机井	管井	洋井
矿井	竖井	立井	斜井
坑道	巷道	平巷	矿坑	窿
工作面	掌子
发电站	发电厂	电站
火电站	热电厂	火力发电厂
仓库	仓	库	栈	仓房	库房	储藏室	堆房	栈房	堆栈	货栈
粮仓	谷仓	仓廪	粮库	粮囤	站
营房	营	寨	营寨	军营	兵营	营盘	老营	兵站
堡垒	壁垒	营垒	碉堡	地堡	桥头堡	碉楼	礁堡
掩体	掩护	掩蔽体
鹿砦	鹿角
壕沟	战壕	壕	堑壕
园林	公园	花园	庄园	园	苑
御花园	御苑
陵园	烈士陵园
花坛	花池子	花圃
草坪	草地	绿地	青草地	绿茵
塔	宝塔	浮屠
象牙之塔	象牙塔
亭	亭子
阁	楼阁
舞台	戏台
讲台	讲坛
站台	月台
坟墓	坟茔	墓葬	陵墓	陵	丘	冢	坟	墓	坟丘	丘墓	青冢	墓茔
陵寝	山陵	寝
坟头	坟山
墓道	神道	墓场
祖坟	祖茔	祖陵
墓穴	穴	窀穸	圹
碑	碣	碑碣	碑石	石碑
墓碑	墓表	神道碑
皇宫	王宫	宫殿	宫阙	宫室	宫廷	宫闱	建章	宫	殿	禁	阙	宫苑	宫内
祠堂	宗祠	祠	庙
太庙	宗庙
佛殿	殿	殿堂
庙宇	庙	庙舍
孔庙	圣庙
寺	寺院	佛寺	禅林	禅房	刹	寺庙	寺观	禅寺
庵	尼姑庵
观	道观
本寺	该寺
教堂	礼拜堂	天主教堂	主教堂
机器	机	机械	机具
农机	农械	农机具
工作母机	母机
蒸气机	汽机	蒸汽机
内燃机	热机
摩托	摩托车	机车
发动机	动力机	引擎
柴油机	狄塞耳机
发电机	电机
电动机	马达	电机
汽轮机	汽机
涡轮机	轮机	透平机	水轮机
燃气轮机	气轮机
起重机	吊车	龙门吊	塔吊
升降机	电梯
天车	行车
钻探机	钻机
凿岩机	风钻	风镐	电镐
水压机	油压机	液压机
织布机	机子	机杼	纺纱机	纺车	纺机	纺织机	细纱机
卷扬机	绞车
掘土机	电铲	推土机	挖掘机	掘进机
联合收割机	联合机	康拜因	收割机
拖拉机	铁牛
铲土机	铲运机
鼓风机	吹风机	通风机	送风机	暖风机	抽气机
压路机	轧机
计算机	电脑	微处理机	微电脑	微机	微型机	微处理器	处理器
输送机	输机
老虎机	赌博机
电子游戏机	游戏机	游艺机
彩电	彩色电视
柜员机	柜机	提款机
内存储器	内存
空调机	空调
烤箱	烘箱
家用电器	家电	小家电
放映机	放像机
工具	器	家伙	家什
泵	唧筒
水泵	抽水机
气泵	风泵
气筒	打气筒
机床	床子
车床	旋床
冲床	冲压机	压力机
刀具	刃具
机件	器件	零件	组件	零部件
激光器	莱塞
化油器	汽化器
绞盘	辘轳
滑轮	滑车
飞轮	飞
齿轮	牙轮
滚珠轴承	球轴承	滚柱轴承	滚动轴承	滚针轴承	滑动轴承	轴承	空气轴承
滚珠	钢珠
主轴	主光轴
传动带	皮带
锁链	锁	锁头
弹簧	绷簧	簧	簧片
发条	弦
合页	合叶
阀	阀门	凡尔	活门	截门
活塞	鞲鞴	活塞环
轴瓦	轴衬
销子	销钉	开口销
离合器	靠背轮
排挡	挡	风挡
履带	链轨
轮轴	轴心	连轴	凸轮轴	滚轴
空气锤	气锤
蒸汽锤	汽锤
劈	楔子
筘	杼
钉子	钉
螺钉	螺丝	螺丝钉
螺母	螺丝母
螺纹	螺丝扣
地脚螺丝	地脚螺栓
锭子	锭
纱锭	纺锭
制动器	闸	刹车
梭	梭子
钥匙	匙	钥
撞锁	碰锁	碰簧锁	弹簧锁
拉链	拉锁	拉锁儿
铁锁链	锒铛
零备件	附配件
电子器件	元器件	电子元件
转子	旋子
步话机	步谈机	步行机
电话机	机子	全球通	公用电话	电话	对讲机	话机	有线电话
电唱机	唱机
留声机	话匣子	唱机
收音机	无线电
电视机	电视
幻灯机	幻灯
受话器	耳机	听筒
发话器	话筒
微音器	送话器	传声器	麦克风	话筒	喇叭筒
扬声器	喇叭	音箱	组合音响	扩音机
拾音器	电唱头
电子管	真空管	灯
继电器	替续器
容电器	电容器
两极管	二极管
原线圈	初级线圈
副线圈	次级线圈
呼机	寻呼机	传呼机
手机	大哥大	部手机	无绳电话机	无绳话机	无绳机	无线电话
电视电话	可视电话
电线	电缆
橡皮线	皮线
电料	电器
电池	干电池	电池组
蓄电池	电瓶
开关	电门	电钮	电键
插头	插销
电闸	闸	闸刀
光电池	太阳电池
农具	耕具
镰刀	镰
锄	锄头	耘锄	耨
耙	耙子	钉耙	钉齿耙	耙犁
犁	犁头
铧	犁铧
耧	耩子
耢	耱	盖
筢	筢子
水车	翻车	龙骨车
戽斗	戽
风车	扇车
碌碡	磙子	石磙
渔具	鱼具	钓具
鱼网	罟	罨	罾
鱼漂	浮子
磨子	磨盘	磨	砻
碾子	碾
碓	石碓
蚕箔	箔
蚕簇	山
锛	锛子
螺丝攻	丝锥
叉	叉子
筛	筛子	罗	滤器
漏斗	漏子	滤斗
扳子	扳手
钎子	钎
砂纸	砂布
千斤顶	千斤
磨刀石	砺石	油石	硎	砥
砂轮	砣子
刀	刀子	刀片
铡刀	铡
錾刀	錾
剃刀	剃头刀
剪	剪刀	剪子
斧	斧头	斧子
刃	口	锋	刀锋	刀口	刀刃	锋刃	刃儿	刃片
锤	锤子	榔头	槌	椎	榔
镐	镐头
洋镐	鹤嘴镐	丁字镐	铁镐
凿	凿子	錾子	錾	雕凿
冰镩	镩子
锹	铁锹	锸
铲	铲子	铲刀
刨	刨子	刨刀
锯	锯子
锉	锉刀	锉子
板锉	扁锉
钳	钳子	铗
镊	镊子
夹	夹子
老虎钳	虎钳	台钳
火钳	火剪
锥	锥子
改锥	赶锥	螺丝起子	螺丝刀
棒	棒子	棍	棍子	杖	大棒	棒槌	棍棒	棍儿	梃子
通条	火棒
木棒	木棍
铁棍	铁棒
擀杖	擀面杖
杠	杠子	杠棒
扁担	担子
墩子	墩
砧板	案板	俎	椹
砧	砧子
模具	胎具
模型	模子	模	型	范
坯	土坯
坯子	砖坯
模板	沙盘	模版
铜模	字模	字样
楦子	楦
夹具	卡具
榫头	榫子	榫
雕版	梓
纸版	纸型
版心	页心
套版	套色版
活版	活字版
仪表	仪器	仪	计	表
电流计	安培计	电流表
电表	电度表
电压计	伏特计
温度计	温度表	寒暑表
体温计	体温表
指南针	南针	司南	罗盘
浑天仪	浑仪	浑象	天球仪
水准器	水平
圭表	圭	圭臬
测试仪	探测仪
流量计	流量表
尺	直尺	尺子
丁字尺	丁字规
表尺	标尺
三角尺	三角板
曲尺	矩尺	鲁班尺	角尺	矩
计算尺	算尺
游标卡尺	卡尺
弓	步弓
秤	衡器	铨	枰
磅秤	台秤	案秤	磅	地磅
秤锤	秤砣	砣	权	夯砣
秤毫	毫	秤纽
斗	斛
炉子	火炉	炉	火炉子
灶	炉灶	锅灶
高炉	鼓风炉
马丁炉	平炉
火油炉	煤油炉
听诊器	听筒
注射器	针
金针	针
脱脂棉	药棉
橡皮膏	胶布
拐杖	拐棍	拐	杖	手杖	双拐	拐棒	拄杖
月经带	卫生带
车	车辆	车子	舆	轸
机车	火车头
火车	列车
轿车	卧车	小车	小轿车	小汽车
自行车	脚踏车	单车	车子
赛车	跑车
篷车	棚车
敞车	敞篷车
闷子车	闷罐车
斗车	罐
铲车	铲运车	叉车
人力车	洋车	东洋车	黄包车	胶皮
手推车	手车	小车
大板车	排子车
平板车	三轮儿
大车	辂
拖车	挂斗	挂车
班车	交通车
灵车	柩车	殡车
车驾	凤辇	辇	驾
船	船舶	船只	舟楫	舟	艇	舫	轮	舡	船儿
小船	扁舟	划子	小艇	舴艋
舶	舸
邮轮	邮船
游船	游艇
汽艇	快艇	摩托船	电船
渡船	摆渡
渡轮	轮渡
救生艇	救难船
舢板	三板
拖轮	拖船
龙舟	龙船
皮划艇	皮艇
筏子	筏	桴
木筏	槎
排筏	排
飞机	铁鸟	机	飞行器
飞艇	飞船
轿子	轿	舆
花轿	彩轿
雪橇	爬犁	冰橇	冰床
舵	艄
桨	桡	棹
帆	篷	船篷	风帆
桅杆	桅	樯	桅樯
舱	厢
车把	把	龙头
方向盘	舵轮
车轮	轮子	轮	车轱辘	轱辘
轮胎	轮带	皮带	胎	车胎	车带
外胎	外带
内胎	里带
鞍	鞍子
辔	辔头
笼头	羁
马鞍	马鞍子
马掌	马蹄铁
鞭子	鞭	策
武器	火器	军火	军械	器械	战具	兵戎	兵器	甲兵	兵	铁	械	刀兵	刀枪	枪炮	枪杆子	家伙
原子武器	核子武器	核武器	核军备
枪	枪支	枪械
步枪	大枪
盒子枪	驳壳枪	盒子
机关枪	机枪
炮	火炮	大炮
无坐力炮	无座力炮
火箭炮	喀秋莎	火箭筒
瞎炮	哑炮
刺刀	枪刺	白刃
弹药	弹
枪弹	子弹	枪子儿
燃烧弹	烧夷弹
榴霰弹	子母弹
氢弹	热核武器
霰弹	群子弹
飞弹	流弹
弹头	弹丸
弹壳	药筒
手榴弹	手雷
炸药	火药	药
梯恩梯	黄色炸药
弓	弩弓	弩
箭	矢
响箭	鸣镝
暗箭	暗器	袖箭	毒箭
箭头	箭镞	镝	镞
箭靶子	靶子	箭垛子	鹄的	的	鹄	臬
矛	长矛	铩	铍	戛
枪	长枪
盾	盾牌	藤牌	干	橹
印尼盾	印度尼西亚盾
剑	宝剑	铗	干将	龙泉
短剑	匕首
上方宝剑	尚方宝剑	尚方剑	上方剑
军舰	兵舰	舰	舰艇	兵船	战舰	艨艟	舰船	舰只	舰群
战列舰	战斗舰	主力舰
护卫舰	护航舰
潜水艇	潜艇
炮艇	护卫艇
战斗机	歼击机	驱逐机
主机	长机
坦克	坦克车
装甲车	铁甲车
火箭	运载火箭	运载工具
纸牌	叶子
骨牌	牙牌
扑克	扑克牌
麻将	麻雀
色子	骰子
旱烟袋	烟袋	烟袋锅	旱烟管
水烟袋	水烟筒	水烟斗
烟斗	烟嘴儿
刑具	大刑
铡刀	铡
镣	脚镣	桎
铐	手铐	梏
镣铐	桎梏
灯	灯火	亮儿
日光灯	荧光灯	白炽灯	白炽电灯
台灯	桌灯
汽灯	保险灯
本生灯	煤气灯
马灯	桅灯
风灯	风雨灯
油灯	灯盏	青灯
灯笼	纱灯
手电筒	电筒	电棒	手电
电灯泡	灯泡	泡子
灯罩	灯伞
灯心	炷
灯台	檠
镜子	镜	鉴
凹面镜	凹镜
凸面镜	凸镜
凹透镜	发散透镜
凸透镜	放大镜	会聚透镜	火镜
三棱镜	棱镜
眼镜	镜子
透镜	镜片
墨镜	茶镜	太阳眼镜	太阳镜
花镜	老花镜
望远镜	千里眼
接物镜	物镜
接目镜	目镜
刷	刷子	抿子
帚	扫帚	笤帚	彗	扫把
鸡毛掸子	掸子	掸帚
拖把	墩布
毛巾	手巾	巾	幂
手绢	手巾	手帕	帕	巾帕
头帕	头巾
肥皂	胰子	枧	洋碱
梳子	梳	篦子	栉	拢子	木梳	梳篦
针	金针	引线	缝衣针	钢针
针鼻儿	针眼
顶针	针箍
线	缕
丝线	绒线	纶
毛线	绒线	头绳	绒头绳
线桄子	线轴儿
针线	针头线脑
锅	釜	煲	镬	镬子	鼎	锅子	鼐
火锅	一品锅
平底锅	铛
高压锅	压力锅
壶	铫
便壶	夜壶
蒸笼	笼屉	笼	屉子	甑子	圆笼	箅子
勺子	勺
舀子	水瓢	水舀子	瓢
匙子	匙	羹匙	调羹
筷子	筷
盆	盆子
钵	钵头	钵子
钵盂	钵
缸盆	瓦盆
澡盆	浴盆
痰盂	痰桶
马桶	恭桶	便桶	马子	粪桶	抽水马桶
瓶	瓶子
冰瓶	保温瓶
暖水瓶	保温瓶	热水瓶	暖瓶
花瓶	花插
吊瓶	输液瓶
盘	盘子
碟	碟子
杯	杯子	盅	盅子	盏	海
酒杯	酒盅	觞	白	觥	觚	樽
坛子	坛	瓮	甏	瓿
酒坛	埕
罐子	罐	罐头
储存罐	储罐
缸子	缸
箱	箱子	箱笼	箧
书箱	笈
信箱	邮箱	信筒	邮筒
竹箱	簏
提箱	手提箱
果皮筒	果皮箱	垃圾箱	垃圾桶
保健箱	急救箱
举报箱	信报箱	信报箱群
盒子	匣子	盒	匣	匦	函	椟
烟盒	香烟盒
八音盒	八音匣子
暗盒	黑匣子
篮	篮子	篮筐	提篮
篓	篓子	簏
背篓	驮篓
笼	笼子
箩筐	箩	筐	筐子
淘箩	筲箕	淘米箩
笆斗	栲栳
簸箕	畚箕
粪箕子	粪筐
提包	手提包	手提袋
麻包	麻袋
沙包	沙袋
钱包	皮夹子	腰包	皮夹
袋	袋子	口袋	荷包	囊	橐	兜	兜子	兜儿
网袋	网兜	络子
纸口袋	纸袋
背搭子	褡裢
套	套子	筒	封套
鞘	韬
书套	书函
被套	被袋
滚轮	虎伏
浪木	浪桥
拉簧	扩胸器	拉力器
杠子	杠
球	球类
乒乓球	台球
康乐球	克郎球
球拍	拍子
弹子	台球
棋	棋子	棋类
棋盘	围盘
乐器	法器
打击乐器	响器
弦乐器	丝弦
古琴	七弦琴
三弦	弦子
二胡	南胡
扬琴	洋琴
六弦琴	吉他
阮咸	阮
箫	洞箫
排箫	参差
笙	参差
笛	笛子	横笛
号	喇叭
号角	角
小锣	铴锣
鼓槌	桴
拍板	鼓板	檀板	板
老弦	里弦
子弦	外弦
幕	幕布	帷幕
布景	景
照相机	相机
摄影机	录相机	摄像机
胶片	软片	胶卷
影片	片子
拷贝	正片
底片	底版	底板
正色片	分色片
文具	文房四宝	笔墨纸砚
印泥	印色
印台	打印台
信封	封皮
图钉	摁钉儿
糨糊	糨子	面糊	浆糊
钢板	誊写钢版
笔	笔杆
毛笔	毫	水笔	聿
钢笔	自来水笔	金笔	水笔
圆珠笔	原子笔
笔套	笔帽
笔铅	笔心	笔芯
墨	松烟墨
墨汁	墨水
纸	纸张	纸头	笺	楮
报纸	白报纸	新闻纸
宣纸	宣
玉版纸	玉版宣
稿纸	原稿纸
信纸	信笺	笺
吸墨纸	吸水纸
手纸	草纸	卫生纸	废纸	卫生巾
砚	砚台	砚池
簿册	簿子	簿	册	本	本子	册子	簿籍	小册子
表册	表
笔记本	笔记簿	记录本	记录簿
帐簿	帐本	簿记	帐册	帐	账册	账本
名册	人名册	花名册	名单	录	榜	谱
户口簿	户口册	户口本
折子	折	奏折
食谱	菜谱	菜单	菜系
聘书	聘约
卡片	卡
承诺卡	保证卡	信誉卡	信用证
名帖	名片	片子	刺	手本
帖	柬	柬帖
请帖	请柬	礼帖
黑帖	无名帖
单据	票据	单子	单	契据	契约	字据	字	票	票子	券	票证
借条	借据	左券
收条	收据	收执
存执	存根	票根	存折
发票	发单
保单	保单	包票	保票
结	保证书	军令状
提单	提货单	货票
门票	入场券
站台票	月台票
往返票	来回票
免票	赠券	招待券	红票
证书	证明	证明书	证件	证	关系
路条	路签	通行证
文凭	毕业证书
执照	照	许可证	证照
行车执照	驾照
合格证	合格证书
凭证	凭据	凭单	证据	凭信	符	信物
虎符	兵符
标志	标记	标示
牌子	牌	标牌
路牌	指路牌	站牌
筹码	筹	码子
签子	签
封条	封皮
幛子	幛
匾	匾额	牌匾	横匾
横幅	横披
界桩	桩子	界石	界碑
令箭	令旗
旗帜	旗子	旌旗	旗	帜	旆	旄	幡	幢
军旗	麾
招子	幌子	市招
旗杆	杠
图章	印章	戳儿	戳记	手戳	图书	图记	钤记	印信	关防	章	印	篆	玺	印鉴
徽章	证章
帽徽	帽章
袖章	袖标	臂章
蜡烛	烛	蜡	炬	火烛
蜡台	烛台
香烛	香火
火柴	洋火	自来火
火把	火炬	炬
纽扣	纽	扣儿	纽子	扣子	衣扣	钮扣
子母扣儿	摁扣儿
襻儿	纽襻
结	结子	扣	扣子	疙瘩	结儿
活结	活扣
死结	死扣
绳	索	缆	绋	绳子	绳索	缆索
缰绳	絷	缰
钢索	钢缆	钢丝绳
链	链子	链条
带	带子	绦	绦子	缨
彩带	彩练
绶带	绂
腰带	褡包
腿带	绑腿
吊带	吊袜带	袜带
桌子	台子	案子	桌	台	案	几
方桌	八仙桌	四仙桌
圆桌	圆台
书桌	书案	写字台	办公桌	一头儿沉	桌案
梳妆台	镜台
条案	条桌	条几
抽屉	抽斗	斗	屉子
椅子	椅	交椅
圈椅	安乐椅	扶手椅
凳子	凳
长凳	条凳
床	榻	铺	床铺	床榻	枕席	卧榻
行军床	帆布床
木床	板床
病床	病榻
橱	柜	档	柜子	橱柜	柜橱	箱橱
碗橱	碗柜
衣橱	衣柜
床边橱	床边柜
保险柜	保险箱
栏柜	拦柜
屏风	屏
卧具	寝具
被褥	铺盖	铺垫	铺陈	铺盖卷
被子	被卧	被头	被	衾
棉絮	棉花胎
褥子	垫被	褥套	茵
草垫子	草荐	稿荐
毯子	毯
枕头	枕
床单	褥单	单子	被单
帐子	蚊帐	帷	帱
席子	席	衽席	凉席	踅子
篾席	竹席	簟	席篾
草席	荐	芦席	席草
帘子	帘
幔	幔帐	帷子	帷子	帷幔
窗帘	窗幔	窗帷	帘幕
帐幕	帐篷	幕	篷	帷幄	帷幕	蒙古包	毡包	毡幕
垫子	垫	垫片	藉
罩子	罩	护罩
奶罩	胸罩	乳罩
面罩	面纱
钟	时钟	钟表
座钟	台钟
表	手表
马表	跑表	停表
怀表	挂表
表针	指针
表盘	表面
漏刻	漏壶	漏	铜壶滴漏
化妆品	脂粉
生发油	头油	发蜡	发乳
唇膏	口红
扑粉	香粉	爽身粉	粉
香水	花露水
饰物	装饰品	装饰	什件儿	饰	饰品
流苏	穗子	穗	旒
发夹	发卡
首饰	头面	妆
戒指	戒	指环	手记	镏子	钻戒
耳环	耳坠子	钳子	珥	耳坠	耳针
项链	项练	项圈
镯子	手镯	镯	钏	玉镯
玉簪	发簪	簪子	珈	簪缨
绣品	刺绣	平金
伞	阳伞	雨伞	晴雨伞
盖	华盖
阳伞	旱伞	遮阳伞
扇子	扇
葵扇	芭蕉扇
团扇	纨扇
电扇	风扇	电风扇
暖壶	汤壶
烘篮	烘笼	手炉
玩具	玩意儿	玩物	玩艺
弹子	玻璃球
风筝	纸鸢	鹞子	断线风筝
玩偶	托偶	土偶	偶人	木偶
拨浪鼓	波浪鼓
铃	铃铛	銮	铎	响铃	铃儿
梆子	梆	柝
哨子	哨	鼻儿
醒木	惊堂木
烟火	焰火	烟花
爆竹	炮仗
双响	二踢脚
鞭炮	鞭
棺材	棺木	木	材	棺	榇	棺椁
灵柩	灵榇	灵	柩
寿材	寿木
骨灰盒	骨灰箱
冥器	殉葬品
灵牌	灵位	牌位	神位
俑	偶人	兵马俑
银锭	锡箔
衣料	料子	布料	面料
毛料	料子
零头	布头
布	布匹	棉布	棉织品	布帛
粗布	毛布	土布
斜纹布	斜纹
羽缎	羽毛缎
卡其	咔叽
花布	印花布
夏布	麻布	缌
灯芯绒	条绒	灯心绒
丝绸	绸缎	绸子	缎子	罗	绸	缎	绉	绨	锦	纺	帛	丝织品	绫椤绸缎
纺绸	小纺
纨	缣
练	缟
柞丝绸	茧绸
香云纱	莨绸	拷纱	拷绸
春绸	线春
彩绸	彩
毛葛	葛
呢绒	呢子	呢	毛呢	毛织品
直贡呢	礼服呢
驼绒	骆驼绒
针织	针织物
衣服	衣物	衣着	衣裳	衣衫	服	装	衣	服装	服饰	衣装	行头	行装
大衣	大氅	皮猴儿	棉猴儿
披风	斗篷
披肩	帔
长衫	大褂	长袍	袍	袍子	袷袢
罩衫	罩袍	外罩	罩衣
内衣	小衣裳	小褂
中装	中服	成衣
西装	西服	洋装	洋服
盛服	盛装
礼服	大礼服	燕尾服
朝服	蟒袍
便装	便服	便衣
外衣	外套
夏装	夏衣
冬装	冬衣	寒衣	棉衣
皮衣	裘
童装	小衣裳
兜肚	兜兜
睡衣	睡袍
军服	军装	戎装	甲胄	盔甲	铁甲	披挂	老虎皮	军衣	装甲
法衣	袈裟	百衲衣	衲	道袍	直裰
戏装	戏衣
孝服	重孝	丧服	素服	缟素	孝
鹑衣	百衲衣
上装	上衣	上身	褂子	短装	短打	袄	紧身儿	衫	褂	小褂儿
背心	马甲	坎肩
马褂	单褂
衬衣	衬衫
汗衫	汗褂
绒衣	卫生衣
裤子	裤	下身	小衣
衬裤	裤衩
绒裤	卫生裤
裙子	裙	裳	裙装
连衣裙	布拉吉	套裙
领子	领	领口	衣领
裤腰	腰	腰身
衣袋	口袋	衣兜	兜	荷包	囊中	私囊
袖子	衣袖	袖管	袖筒	袖	袂
衣襟	衽
大襟	裾
后襟	后身
前襟	前身
帽	帽子	冠	笠	盔	冕	冠冕	帽盔	头盔
斗笠	箬帽	斗篷	草帽	毡笠
小帽	瓜皮帽
纱帽	乌纱帽	乌纱
皇冠	王冠
鞋	鞋子	屣	履	舄	屐	屦
拖鞋	趿拉儿
木屐	趿拉板儿
皮鞋	革履
绣花鞋	绣鞋
雨鞋	钉鞋	套鞋	胶鞋
跑鞋	钉鞋	球鞋	运动鞋
靴	靴子
头巾	网巾	帻
围巾	围脖儿	围脖
袜子	袜
手套	拳套
粮食	食粮	粮	菽粟
干粮	糇粮	糗
粗粮	糙粮
米	大米	白米	稻米	精白米
籼米	机米
碎米	粞
江米	糯米
糙米	粝
秫米	高粱米
米粒	糁	饭粒
米粉	米面
面粉	白面	面
玉米面	棒子面
麸子	麸皮
饲料	草料	秣	食	料	饲草
粮草	粮秣
鱼饵	钓饵	饵	饵料
鱼虫	金鱼虫	水蚤
食物	食品	食
饭食	饭菜
熟食	烟火食	烟火
消夜	飧
主食	主食品
副食	副食品
零食	零嘴
肉品	肉食品	肉制品
饭	米饭	白饭	白玉	白米饭
盖饭	盖浇饭
份儿饭	客饭	份饭
粥	稀饭	米汤	糜
羹	肉汤
锅巴	锅贴
面条	面
汤面	面汤
抻面	拉面
削面	刀削面
卷子	卷	花卷
馒头	包子	馍	馍馍	饽饽
饼子	饽饽
杂粮	粗粮
窝头	窝窝头
油茶	油茶面儿
菜肴	菜	小菜	菜蔬	下饭
酒食	酒饭	酒菜
美食	美味	佳肴	珍馐	美食佳肴	佳肴珍馐
山珍海味	水陆	山珍	生猛海鲜
糟糠	粗茶淡饭
冷盘	拼盘	小吃
菜码儿	浇头
荤菜	荤腥	油腻	肴	大鱼
全家福	一品锅
鱼鲜	海鲜
肉排	排骨
肉末	肉松	肉丝
肉丸	狮子头
脯	腊肉	咸肉
烤肉	炙
猪蹄	蹄子	爪尖儿
粉蒸肉	米粉肉
白肉	肥肉
杂碎	下水	上水
肥肠	圈子	肠儿
虾米	海米	虾皮
干贝	江珧柱
鱼翅	翅	翅子
鲞	鲞鱼
咸鱼	鲍鱼
松花	松花蛋	皮蛋	变蛋
肉片	脔	肉类
生肉	鲜肉
素菜	素	斋	素餐
千张	豆腐皮
豆腐干	香干
豆腐乳	酱豆腐	腐乳	豆乳
豆腐皮	豆腐衣
豆芽儿	豆芽菜	豆芽
粉条	粉
粉丝	粉
调味品	作料	调料	佐料
八角	大料	茴香
味精	味素
淀粉	小粉
胡椒	胡椒面
姜	生姜
花椒	椒
动物淀粉	糖原
油	食油
素油	清油
猪油	大油	荤油
菜油	菜子油	清油
茶油	清油
花生油	生油
芝麻油	麻油	香油
板油	脂油
盐	食盐	氯化钠	盐巴	积雪	鹾	盐粒	盐类
岩盐	矿盐
酱	醢
芝麻酱	麻酱
果子酱	果酱
醋	醯	酢	陈醋	苦酒	白醋
糖	食糖	糖类	糖料
点心	点	茶食
甜食	甜品	甜点	糖食
糕点	饽饽
糕饼	饵	果饵
饼	饼饵
烙饼	饼子
烧饼	大饼	火烧
油条	油炸鬼
饺子	饺
汤圆	汤团	元宵	圆子
团子	团	饭团
粽子	粽
馄饨	抄手
江米酒	酒酿	醪糟
糖果	糖	糖块
饴糖	饴	麦芽糖	糖饴
糖稀	饧
糖葫芦	冰糖葫芦
蜜饯	果脯	脯	桃脯
果料儿	果仁儿	果料
馅料儿	心子	馅
酵子	鲜酵母
发粉	起子
酒曲	酒母	曲	酒药
面肥	发面
饮料	饮	饮品
豆浆	豆乳	豆汁	灏
可可	可可茶
咖啡	咖啡茶	雀巢咖啡
冰棍儿	冰糕	冰棒	棒冰	雪条	冰棍
冰激凌	冰淇淋
冰糕	雪糕
茶	茶叶	茗
砖茶	茶砖
花茶	香片
茶晶	茶卤
酒	酿	酒浆	杯中物
美酒	醇酒	醇醪	醑	琼浆	玉液琼浆	名酒	佳酿	琼浆玉露
黄酒	绍兴酒	绍酒	老酒	陈酒	花雕
白酒	烧酒	白干儿
甜酒	醴
清酒	水酒	酤	酒水
乳酪	酪
酥油	油
药品	药物	药	药味	药石	药料
中药	国药	中医药	中药材
丸	丸药	药丸	丸剂
散	药粉	药面	散剂
膏	膏药	药膏
汤药	汤	汤剂	药水	药液	口服液
药引子	引子	药饵	药捻子　
饮子	饮
针剂	针
试剂	试药
冲剂	浸剂
麻醉剂	蒙药	麻药
栓剂	坐药	药栓
制剂	药剂	剂
酊剂	酊
酏剂	酏
醑剂	醑
灵丹	妙药	灵丹妙药	特效药	圣药	苦口良药
青霉素	地霉素
磺胺	氨苯磺胺
牛痘苗	痘苗
结核菌素	结素
安眠药	催眠药
红汞	汞溴红	红药水
龙胆紫	甲紫	紫药水
麝香	麝
奎宁	金鸡纳霜
阿胶	驴皮胶
蜂王浆	王浆	蜂皇精	蜂乳	蜂王精	花露	花蜜	槐花蜜
蜂蜜	蜜	蜜糖
樟脑丸	卫生丸
滴滴涕	敌百虫	敌敌畏	敌杀死	六六六
避孕片	避孕药
咖啡因	茶精	茶素
造影剂	显影液
维生素	维他命
维生素	烟酸
补品	滋补品	滋养品	营养	营养片	营养品	营养素	蜜丸子	补药
保鲜剂	防腐剂
去污剂	清洁剂
毒品	毒物	毒药	毒	毒饵
毒酒	鸩毒	鸩	鸩酒
海洛因	白面儿	白粉
鼠药	耗子药
鸦片	阿片	大烟	烟土
砒霜	白砒	红砒	信石	红矾
烟	烟草
香烟	纸烟	烟卷儿	烟	烟卷
雪茄	卷烟	吕宋烟
烟斗丝	斗烟丝
烟丝	烟
烟头	烟蒂	烟屁股
阳历	太阳历	公历	太阳年
阴历	太阴历	夏历	旧历	农历
伊斯兰教历	回历
公元	纪元
时代	年代	世代	年月	纪元	世
古代	古	先	上古	太古	洪荒	远古	史前	古时	邃	天元
近代	近现代
现代	当代	现世	今世	现当代	现时代
盛世	治世
乱世	浊世
新篇章	新纪元
朝代	王朝	朝	代	时
历朝历代	历代
年代	年岁	年间	年份
时期	时代	时日	一时	一代	一世	时	期	秋
年月	日月
时间	时刻	时日	工夫	日子	光阴	时光	韶光	韶华	年华	年光	流光	流年	年月	岁月	岁时	日	时	辰	时空
日期	日子
一向	阵子	晌
时候	时节	时分	时刻	天时	天道	早晚	当儿	时光	辰光	时	际	上	下	时段
时机	天时	机会	机遇	机	会	时	隙	空子	火候	机时
关头	关键	转机	转折点	转捩点	关口	契机	节骨眼	当口儿	关	紧要关头	之际
平时	平常	平日	素日	素常	平素	平生
暇时	闲暇	余暇	闲空	空闲	闲工夫	空	暇	闲	隙	间	余	空隙	间隙	空当儿	茶余饭后	茶余酒后	空余
期限	限期	期	定期	时限	年限	为期
期间	间	中	内	里	次	中间	之间	里边	里头	里面	以内	之内
始终	前后	自始至终
初期	前期	早期	初	头	首	最初
年初	年头	岁首	开春	新春	新年	新岁
月初	朔望
中期	中叶	中	半
正月十五	月中
末期	后期	晚期	末叶	末世	末代	末年	末梢	末了	末尾	终了	末	底	终	阑	杪	季	晚	深	暮	期终	期末	末日
年终	年底	年末	岁末	岁暮	岁尾	残年	年尾	年根儿	年关
月终	月底	月末	月杪
现在	现时	如今	当今	现今	而今	于今	今朝	今	兹	本	现	现下	今天	今日	现行	现如今	今昔	现在时
目前	眼前	当前	眼下	眼底下	目下	当下	脚下	时下	即	时	此时此刻	手上	现阶段
过去	从前	已往	以往	往常	往昔	平昔	昔日	往日	旧日	旧时	往年	早年	昔年	畴昔	昔	往	往时	陈年	既往
自古	古来	终古	亘古	旷古	古往今来	自古以来	以来
从小	自小	自幼	生来	有生以来
至今	迄今	于今	至此	由来	时至今日	迄今为止	从那之后
以前	先前	先	早先	原先	在先	此前
事先	之前	前	事先	前面	前头	先头	头里	事前	有言在先
前夕	前夜	昨晚	昨夜
近来	近日	新近	最近	日前	近年	前不久	不久前	近年来	近些年	多年来	以来	连年来	近期	近世
将来	未来	明日	明天	明朝	前	来日	他日	明晚	明晨
即日	不日	日内	在即
改日	改天	来日	他日	下回
以后	之后	后	往后	而后	尔后	日后	今后	此后	从此以后	嗣后	随后	过后	后来	后头	下	事后	其后	然后	从此	自此
一会儿	不一会儿	不久以后
身后	百年之后
隔日	间日
一生	一世	终身	终生	毕生	平生	一辈子	生平	终天	百年	一生一世	辈子	长生
今生	今世	现世	今生今世
半生	半世	半辈子	大半生
前半辈子	前半生
后半辈子	后半生
年龄	年纪	年岁	岁数	春秋	年华	年事	年	岁	庚	龄	齿
不惑	不惑之年
半百	知天命之年
高龄	遐龄	高寿	大寿	年过花甲	年近花甲	耄耋高龄	年过半百	年逾花甲	耆
牙口	口
低龄	幼龄
童年	幼年	童稚	小儿	孩提	襁褓	垂髫	髫龄	髫年	总角	儿时	幼时	小时候
少年	妙龄	豆蔻年华
青年	青春	韶光	韶华	华年	妙龄	花季	黄金时代
壮年	中年	盛年
晚年	老年	老境	暮年	岁暮	残年	残生	余年	余生	夕阳	耄耋之年	有生之年	风烛残年	桑榆暮景	老龄	天年	垂暮之年	中老年	龙钟	年长
年	年份	年度	兹	载	岁	春	夏	秋	东	稔	春秋	寒暑	阴历年
十年	旬	秩
百年	世纪
今年	当年	本年	现年	当年度
明年	来年	翌年	过年	新年	明
去年	去岁	上年	头年	旧年	旧岁
每年	年年	历年	岁岁年年	每年度	年年岁岁
四季	四时	一年四季
春	春季	春天	春令	青春	阳春	春日	去冬今春
初春	开春	新春	早春
暮春	季春
夏	夏季	夏天	夏令	夏日	暑天	三夏	伏季	夏令时
初夏	夏初
炎夏	炎暑	伏暑	大暑	盛暑	酷暑	隆暑	三伏	烈暑	三伏天	盛夏
秋	秋季	秋天	秋令	三秋	金秋
深秋	晚秋	暮秋
冬	冬季	冬天	冬令
严冬	隆冬	寒冬	深冬	寒冬腊月	腊	十冬腊月
季节	季	时令	令	时节	时	喷
黄梅	黄梅季	霉天
伏天	三伏
中伏	二伏
末伏	三伏
数九	九	数九寒冬	数九寒天
月	月份	月度
正月	新月	元月	岁首	一月	元月份
二月	仲春
三月	季春	暮春
四月	四月份
五月	仲夏	五月份
八月	仲秋
九月	暮秋
十月	小阳春	阳春	小春
十一月	仲冬
十二月	腊月
小月	小建	小尽
星期	周	礼拜
星期一	周一	礼拜一
星期二	周二	礼拜二
星期三	周三	礼拜三
星期四	周四	礼拜四
星期五	周五	礼拜五
星期六	周六	礼拜六
星期日	星期天	星期	礼拜天	礼拜日	礼拜	周日	周末	小礼拜
日	天
当日	当天	即日	同一天
今日	今天	今儿	今儿个	今朝	今
明日	明天	明儿	明朝	明	次日	翌日
昨日	昨天	昨	昨儿	昨儿个
前日	前天	前一天	头天
初一	朔日	朔	正月初一
月半	望日	望
月底	晦
每日	每天
双日	单日
半日	全天
节气	节
夏至	长至
冬至	长至
节日	节	纪念日	节假日
佳节	节令
妇女节	三八节	三八妇女节
劳动节	五一节
八一建军节	八一	建军节
除夕	年夜	大年夜	除夕夜
年初一	大年初一	元旦	正旦	三元
春节	年节	新年	新春	新春佳节
元宵节	上元节	灯节
端午节	端午	端阳	五月节
中秋节	八月节	团圆节	中秋
重阳节	重阳
假日	假期	休假	假
生日	诞辰	生辰	寿辰	寿诞	华诞	大庆	八字
忌日	忌辰
婚期	佳期	好日子
吉日	好日子	黄道吉日
黎明	凌晨	拂晓	破晓	向明	曙	昕	晨夕
早晨	早上	早	朝	晨	早起	天光	早间	晁
清晨	一清早	大清早	清早	一早	大早	一大早
朝朝暮暮	花朝月夕
上午	午前	前半天	上半晌	前半晌
中午	正午	午	晌午	日中	午间
下午	午后	下半天	后半天	下半晌	后晌
白天	白昼	日间	昼	大白天	大天白日	青天白日	光天化日	白日	昼间	大清白日
傍晚	黄昏	垂暮	薄暮	擦黑儿	暮	夕	迟暮
晚上	夜晚	晚间	夜里	夜间	晚	夜	夜幕	宵	夕
当晚	当夜	连夜
夜间	夜里	星夜	夜	夕
半夜	夜半	三更	子夜	午夜	中宵	夜分
深夜	漏夜	深更半夜	黑更半夜	半夜三更	三更半夜
前半夜	上半夜
后半夜	下半夜
昼夜	日夜	白天黑夜
早晚	晨昏	朝暮	朝夕	旦夕
小时	钟点	钟头	时
时	点钟
学时	课时
时辰	时	辰
这时	这时候	这	此时	此刻	这儿	这会儿
那时	那时候	当时	当初	当下	当场	那儿	那会儿	那阵子	其时	彼时	当年
几时	何时	多会儿	哪会儿	哪一天	何日
方向	方位	方面	方	向
同方向	一顺儿
位置	部位	地位	位	窝
座位	位子	席位	席	座	坐位	坐席	座席
上座	上位	首席	首座
下位	末座
铺位	床位
东南西北	四方
东	东方	东边	左	正东	东面	东头
南	南方	南边	正南	阳	南部	南缘	阳面
西	西方	西边	正西	右	西头	西部	西面
北	北方	北边	朔	正北	阴	北部	北缘	北头
上	上面	上边	上头	上端	顶端	头	上方
以上	之上	如上	上述
下	下面	下边	下头	底下	底	脚	下部
以下	以次	之下	偏下
左	左面	左边	左首	左手	上手	上首	里手	左侧	左方
右	右面	右边	右首	右手	下手	下首	外手	右方	右侧
前	前面	前边	前头	前方	头里	先头	眼前	面前
后	后面	后边	后头	背后	末端	末尾	尾	后身	后部
中	中间	中心	中央	正中	当中	居中	正当中	当腰	当心	当间儿	当道	半	间	心	之中	中部	中点	中段
内	中	里	里面	里边	里头	以内	之内
深处	奥
国内	海内	境内
外	外面	外边	外头	外界	以外	之外	外围	外侧	外圈	外场
室外	露天	窗外	户外
野外	郊外
国外	海外	域外
内外	里外
旁边	边缘	边沿	边际	边	旁	畔	沿	滨	浒	干	际	两旁	一旁	边上	一侧	外缘
耳畔	耳际
附近	就近	邻近	近处	一带	内外	左右	左近	前后	近水楼台	就地	近旁	跟前	不远处
手头	手边	手下
周围	四周	四围	周缘	方圆	四邻	四下里	郊	四郊	四下	四周围	四旁
对面	对门
天	天空	空	宵	圆	天上	皇上	天宇	玉宇	上苍	苍天	天幕	天穹	苍穹	穹苍	太虚	老天	穹幕	穹	中天	昊
高空	太空	云霄	九霄	九天	云天	云汉	霄汉	九重霄	满天	重霄
晴空	青天	碧空	蓝天
空中	空间	上空	长空	半空	半空中
天际	天边	天极
地	大地	壤	土地	地皮	方	大方
地方	地域	地区	地面	地段	地带	处	所在	域
市区	城区	城厢
故地	旧地
空地	隙地
立锥之地	弹丸之地
源	源头	发源地	策源地	发祥地	摇篮
北国	北疆
地点	地址	地方
汇合处	交界处	交汇处
农技站	农技推广站
灌溉站	排灌站
推广站	宣传站
飞机场	机场	航空站	航站
空白点	空白处
宅基地	居所	住地	居住地
到处	各处	各地	处处	所在	随处	四方	八方	四处	四下里	万方	四海	五湖四海	五洲四海	大街小巷	街头巷尾	四面八方	满处	无处	天南地北	无所不至	四野	遍野	无所不在
遍地	匝地
山区	山国	山窝窝	山窝
水乡	泽国
上游	上流
中游	中流
下游	下流
远方	远处	天边	海外	天涯	边塞	塞外	异域	地角	角落	角	山南海北	天	天涯地角	天涯海角	海角天涯	地角天涯
边远	边地	边陲
僻壤	荒漠	乡曲	阴山背后	穷乡僻壤
内地	腹地
前方	前线	前敌	前沿	火线	战线
阵地	防区	战区
后方	大后方	总后方	后
驻地	营地	军事基地	营	营寨	寨	大本营	本部	基地
战场	疆场	沙场	战地
领土	疆土	疆域	领域	土地	幅员	国土	河山	山河	金瓯	版图	寸土	锦绣河山	海疆
孤岛	半壁江山
属地	采地	领地	封地
失地	敌占区	沦陷区
边疆	边界	国境	国门	边陲	边防	边境	边疆区	边区
界线	界	垠	际	分界	限界	界限	疆界	境界	边界	地界	边际	疆	畛域	鄂
本地	本土	当地	该地	地方	地面	地头
外地	外边	他乡	外乡	异乡	异地
家乡	故乡	本乡	乡	里	本土	故园	家门	乡里	乡土	邻里	梓里	桑梓	本乡本土	故里	故土	出生地	母土	诞生地	闾里	热土
胜地	佳境	胜景	妙境	画境	仙境	名胜	名山大川	蓬莱仙境	仙山琼阁
乐园	乐土	福地	鱼米之乡	天府之国	米粮川	世外桃源	天府
树荫	绿荫	荫	树凉儿	浓荫
荒地	荒	荒郊	荒丘	野地
坟地	墓地	坟茔	茔	坟山	乱坟岗	墓园
要地	要冲	要害	要隘	要塞	重地	中心	重镇	锁钥	门户	咽喉	险要	必争之地
险地	险	险隘	天险	山险	险工	绝地	危险区	鬼门关	龙潭	虎口	虎穴	龙潭虎穴	刀山火海	深沟高垒	悬崖峭壁	火海刀山
关口	关	边关	雄关	关隘
卡子	卡	关卡
廉洁关	廉政关
验收关	检验关
设卡	立卡
渡口	渡头	渡	津
路口	街口	街头
十字路口	十字街头
岔口	三岔路口
通道口	入口	进口
缺口	破口	裂口	豁口	豁子	断口
决口	决	口子	溃决
洞	孔	窦	漏洞	孔洞	孔穴	穴	窟窿	窟窿眼儿	鼻儿
山洞	岩洞	洞穴	隧洞
地洞	地道	坑道	坑	地穴	地窟
卯眼	凿	榫眼
缝	罅	罅隙	缝隙	孔隙	裂隙	裂缝	缝子	夹缝	中缝	缝缝	骑缝
空隙	空儿	空子	当儿	空当
坑	坑穴	埂
点	心
线	线条	线段
垂线	垂直线
圆心角	中心角
多面角	立体角
倾角	倾斜角
磁倾角	倾角	磁偏角
面	平面
剖面	切面	断面	截面
横剖面	横切面	横断面
纵剖面	纵切面	纵断面
水平面	水准	海平面
立方体	正方体	立方
球体	球	圆球
角锥体	棱锥
角柱体	棱柱体
几何体	立体
拐角	拐弯	转角	拐	曲	套	弯	隈
角落	犄角	旮旯儿	角	隅	陬	旮旯
城市	市	城	都	邑	垣	都会	都市	城邑	城池	通都大邑	地市
码头	埠	船埠	埠头	浮船坞
大都市	大都会	大城市
我市	本市
危城	旧城	坚城	古城	古都	故城
集镇	镇	镇子	市镇	乡镇	村镇	城镇
乡村	农村	乡间	乡下	乡	果乡	山乡	村野	村村落落	村村寨寨	小村	小村子	村屯	乡野
村庄	村	庄	村子	村落	聚落	庄子	屯子	农庄	山村
荒村	三家村
寨子	寨	村寨	边寨	大寨	山寨
车站	站
港口	口岸	港	海港	海口	港湾	停泊地
道路	路途	路径	路	径	程	道	途	蹊	衢	馗	通衢
陆路	旱路
水路	水道	海路	水程
大路	大道	通道	通途	坦途	通路	康庄大道	阳关道
小路	便道	小径	蹊径	羊肠小道	羊道
山路	山道	山径
弯路	弯道	曲径	之字路
岔路	岔道	岔子	歧路	三岔路
远路	远道
近路	近道	抄道	捷径
要道	孔道	要路	要冲	咽喉
隘路	畏途
中途	半途	半道	半路	路上	途中	旅途
高架道路	高架路
盘山路	盘山道
主干路	主干道
路线	路	线	线路	路经
轨道	轨迹
航路	航线	航道	航程
场所	处所	场地	场子	场院	场道	场合
现场	当场	实地
住所	寓所	寓	居	舍	邸	家	公馆	下处	安身之地
哨所	岗哨	观察哨	岗
试场	考场	试院	闱
市场	商场	市井	市
集市	市集	圩场	庙会	集	街	场	庙	会	摆	墟	集贸
刑场	法场
屠场	屠宰场
会馆	会所
容身之地	宿处	寓舍
英雄无用武之地	无用武之地
妓院	烟花巷	窑子	北里	花街柳巷	秦楼楚馆
巢穴	老巢	老营	窟	窝	窝巢
匪巢	匪窟	匪穴	强盗窝	贼窝
赌窟	赌场	赌窝
这里	这边	此地	此间	此处	此
那里	那边
哪里	何处	哪儿	何方	何地
事情	事	务	政	事宜	事务	事体	碴儿	事儿
事项	须知
两回事	两码事
事实	实事	实际	现实	史实
国事	国务	国事	国家大事
政事	政务
外事	外务	洋务
要事	大事	盛事
公事	公务	公干	公	差	差事
急事	急	警	缓急
危险	奇险
难事	难题	苦事
时事	新闻	时务
趣事	佳话
好事	佳话	美谈	好人好事	幸事
乐事	快事	赏心乐事
喜事	好事	喜	美事	雅事
婚事	亲事	婚姻	亲	婚	喜事	大喜事	天作之合	终身大事
丧事	白事	后事	横事
红白喜事	红白事
佛事	法事	功德	香火	道场	水陆
憾事	恨事	憾	遗恨
世事	尘世	尘事
逸事	轶事	佚事
奇事	怪事	咄咄怪事	蹊跷	跷蹊	特事
遗事	事迹	纪事	史事
风流韵事	韵事	雅事
琐事	琐屑	琐碎	小事	闲事	小节	末节	细节	枝节	枝叶	细故	细枝末节	麻烦事	杂事
家事	家务	家务事	家政
秘事	秘密	奥秘	隐秘	隐私	阴私
机密	事机	天机	军机	机关
亏心事	缺德事
坏事	勾当	劣迹	坏人坏事
丑	丑事	丑闻	秽闻
鳞爪	片断	一鳞半爪
蠢事	傻事
非公务	私事
事事	万事	诸事
新鲜事	新人新事
风险	高风险
事件	事变	风波	波	轩然大波
惨案	血案
事故	事	故	事端	岔子	问题
麻烦	枝节	疙瘩	纠纷
意外	万一	不虞	长短	好歹	差错	闪失	三长两短
变故	变	情况	事变	变动	变化	风吹草动	晴天霹雳	平地风波
波折	曲折	一波三折	反复	几经周折	历经沧桑	饱经沧桑
沧海桑田	沧桑	翻天复地
动乱	变乱	乱	骚动	骚扰	扰动
十年动乱	十年浩劫
风潮	浪潮	潮	大潮
狂澜	狂飙	风暴	风浪	大风大浪	狂风恶浪	惊涛骇浪	暴风骤雨	狂风暴雨	雷暴	风口浪尖	惊涛激越	风云突变	冰风暴
涡流	水涡	旋涡	漩流
群众运动	人民战争
工人运动	工运	工潮
狂潮	热潮
事例	例	例子	例证
比方	譬喻	比喻	譬	举例	举例来说
先例	前例	成例	成规	旧案	判例	先河
惯例	向例	常例	定例	常规	老	规矩	老办法	老框框	老规矩	老例
案件	案子	案	公案
血案	命案	凶杀案	杀人案	谋杀案
疑案	悬案	无头案
冤案	冤狱	错案	假案	冤假错案
投诉案	诉讼案
本案	该案	此案
大要案	大案要案
疑问	问号	问题	疑案	疑团	疑难	疑窦	疑点	疑云	疑义	谜	闷葫芦	狐疑	疑阵
嫌疑	嫌	瓜田李下
过程	进程	经过	历程	长河
始末	本末	首尾	起讫	原委	源流	事由	前后	前前后后	前因后果	来龙去脉	全过程
内中	其中	此中	中间	其间	里头	里边	里面	内部	里	内	中	间	个中	之中
开端	肇端	发端	开始	肇始	起始	起首	起头	起初	开头	劈头	苗子	苗头	开场	序曲	序幕	前奏	先声	胚胎	伊始	原初	开局
破天荒	开天辟地	第一遭
新春伊始	新年伊始
末尾	末了	末	末梢	结尾	煞尾	尾声	尾子	末后	最后	最终	终极	说到底	末段
结局	终局	了局	结幕	终结	归结	收场	下场	结果	归根结底
往事	旧事	成事	旧闻	前尘	历史	陈迹	史迹	老黄历	明日黄花	过眼云烟
经历	阅历	资历	阅世
历史	史
艳史	浪漫史	罗曼史
病历	病案	病史
古代史	古史
科学史	科技史
建筑史	建设史
政策史	谋略史
战史	军史	战争史
医史	医学史
前途	前景	前程	鹏程	未来	奔头儿
出息	争气
遭遇	遭际	际遇	景遇	境遇	身世
风浪	风霜	风雨	大风大浪
宦途	仕途
冷遇	冷眼	冷板凳
惨境	凄风苦雨
冷暖	炎凉	甜酸苦辣	酸甜苦辣
顺境	佳境
逆境	下坡路	下坡
命运	气运	气数	运	运气	命	天命	数	天数	大数	造化	流年	天意	天机	天时
红运	幸运	天幸	吉人天相
苦命	薄命
背运	厄运	灾星
时运	时气
同呼吸共命运	共命运
福气	福分	造化	幸福	福	祜	祉	祚	福祉	鸿福	洪福
灾祸	灾难	灾殃	难	厄	劫	劫数	不幸	三灾八难	天灾人祸
灾害	灾患	灾	灾荒	成灾
祸事	祸乱	乱子	娄子	祸害	祸患	祸殃	祸祟	祸	害	殃	患	巨祸	大祸
浩劫	灭顶之灾	洪水猛兽	天灾人祸	劫难	万劫不复
横祸	横事	飞灾	飞来横祸	无妄之灾
祸根	祸胎	祸端
兵乱	兵燹	战乱	战祸
匪祸	匪患
外祸	外患	敌害
遗祸	后患
天灾	灾荒	自然灾害	荒灾
涝灾	涝害	内涝
水灾	水患	洪灾	水害
火灾	火警
旱灾	大旱	亢旱
饥荒	饥	荒	饥馑	粮荒
海难	海事
地震	地动	震	震害
虫灾	虫害
风灾	风害
祸福	吉凶	休戚	旦夕祸福	安危祸福
苦痛	痛苦	苦楚	痛楚	酸楚	苦处	痛处	苦头	苦难	苦水	苦	切肤之痛
疾苦	困苦	痛痒	瘼
磨难	折磨	千磨百折	千难万险
难题	难点	难处	难关	困难	难	艰
挫折	失败	失利
冤屈	冤枉	屈	冤	枉
沉冤	不白之冤	覆盆之冤
恩惠	恩典	恩德	恩泽	恩情	恩遇	雨露	人情	好处	春晖	恩	惠	德
大德	大恩大德	洪恩	泽及后人
甜头	小恩小惠
活命之恩	救命之恩	再生之恩
冤仇	冤	仇	仇恨	仇怨	睚眦
切骨之仇	深仇大恨	血海深仇	血仇	苦大仇深	血债
世仇	旧恶	宿仇
恩怨	恩仇	恩恩怨怨
分歧	龃龉	矛盾
嫌隙	隙	嫌	裂痕	芥蒂	隔阂	隔膜	疙瘩	碴儿	不和	衅	夙嫌	纠纷	纠葛	争端	失和
荣誉	荣耀	荣幸	光荣	光彩	光	荣	骄傲	桂冠	殊荣
耻辱	羞辱	耻	辱	垢	侮辱	污辱	屈辱	奇耻大辱
污点	秽迹
荣辱	盛衰荣辱
成就	造就	成	大成	成绩	劳绩	成法	实绩
收获	果实	成果	硕果	结晶	名堂	一得之功	胜利果实	战果	胜果
建树	卓有建树
新绩	纪录
功劳	功	贡献	功绩	劳绩	功德	赫赫功绩	绩	佳绩
一等功	头等功	头功
勋劳	勋绩	勋业	功勋	勋
业绩	功绩	事功	功业
殊勋	奇勋
战功	武功	战绩	汗马功劳	军功	胜绩
伟绩	伟业	丰功伟绩	奇功伟业
功在千秋	功在当代	丰功	大功	居功至伟	奇功
过失	过错	疏失	失误	失闪	闪失	毛病	罪过	非	过	错	失	罪	咎	愆	眚	尤	瑕	疵	疵瑕
功过	功罪
是非	好坏	长短	黑白	曲直	是非曲直	是是非非	对错	贬褒	敌友
差错	过错	错误	错处	偏差	偏向	不是	谬误	舛误	讹误	不对	讹谬	纰缪	错	差	病	误	讹	谬	鲁鱼亥豕	鲁鱼帝虎	大过	错事
一差二错	阴差阳错	阴错阳差	误会	言差语错
漏洞	漏子	破绽	纰漏	罅漏	马脚	尾巴	狐狸尾巴
经验	体验	体会	心得	感受
教训	鉴	殷鉴	鉴戒	覆辙	前车之鉴	以史为鉴	后车之鉴
借鉴	龟鉴
印象	记忆
生命	性命	命	活命	人命	民命	身	生
生死	存亡	死活	阴阳	生死存亡	生老病死
寿命	寿	寿数	人寿
长命	长寿
残生	余生	劫后余生	虎口余生
生活	日子	光阴	光景	小日子
衣食	家常	寝食	衣食住行	家长里短	柴米油盐
性生活	性行为	房事	云雨	人道	欢
戎马一生	戎马生涯
身心	心身
生计	活计	生涯	生路	生
饮食	茶饭	膳食	膳	伙食	伙	饭食	口腹	餐饮
西餐	大菜
便饭	便酌	家常便饭	家常饭
酒饭	酌
早饭	早餐
中饭	午饭	午餐	午宴
晚饭	夜饭	晚餐	夜餐
包饭	包伙
消息	新闻	情报	讯	谍报	快讯	讯息	资讯
风声	风	声气
佳音	福音	捷报	喜讯
传闻	传说	传言	道听途说	小道消息	齐东野语	据说	据称	空穴来风
死讯	死信	凶信	凶耗	噩耗
谣言	谣	谣传	妄言	无稽之谈
桃色新闻	绯闻
音信	音问	音讯	音息	消息	信息	信	音	音尘
形势	情势	阵势	局势	局面	事机	事态	气候	风云	风色	风头	风声	势派	态势
现势	现局	现状
危局	危亡	败局	死棋
全局	大局
时势	时局	时务
平局	和局	平手	和棋
趋势	趋向	倾向	动向	方向	势头	大势	来势	来头	样子	势	大方向	主旋律	矛头	可行性	取向	自由化	系列化
长势	生势	走势	涨势	增势	升势
颓势	下坡路	低谷
潮流	浪头	新款	保龄球热	旅游热	投资热	主潮	学习热	办水热	房地产热	散文热	中国热	开发热	兼并热	金融流	回归热
情况	情形	情状	情事	状	情	景	事态	状况	状态	景况	情景	场面	动静	气象	景象	图景
真情	实情	实况	实际	事实	真相	谜底	实
内情	内幕	底细	底子	就里	底	老底	根底	路数	虚实	背景	来历	黑幕	底牌	内参	手底下
来头	来路	来历
详情	端详	详
概况	概貌	大概	概观	概略	大要	大略	崖略	轮廓	简况	廓	外廓
境况	光景	境遇	手头	手下	手边
老境	晚景
家境	家道
病情	病况	病状
市面	市场	商海
世面	场面	场景
实景	实处
境地	境域	情境	处境	地	境	步	地步	田地
困境	困厄	困处	苦境	泥坑	泥沼	穷途	末路	穷途末路	窘况	窘境
惨境	火坑	地狱	活地狱	苦海	渊海	炼狱	人间地狱
绝境	绝地	死地	深渊	万丈深渊	无可挽回
险境	危境
境界	境域	化境	境地	境	程度	地步
意境	意象
佳境	梦境
梦乡	梦境
环境	条件
气氛	空气	氛围
现象	象
陨石雨	流星雨
迹象	征象	征候	形迹	行色	蛛丝马迹	征
苗头	苗子	意思
症状	症候	病症	病象	病征
预兆	先兆	兆头	兆	朕	征兆	前兆
吉兆	彩头	祥瑞
凶兆	不祥之兆	恶兆
下落	着落	着	落子	归着	垂落
踪迹	踪影	来踪去迹
行踪	行止	行迹
气候	天候	气象	天气	天	天道
月令	节令	时令
季风气候	小气候
收成	收获
年成	年光	年景	年
秋景	大秋
丰年	大年	熟年
平年	常年
荒年	歉年	歉岁	凶年
效用	功用	作用	功能	职能	效能	效	功效	功力	效力	力量	效果	成效	效验	效应	效益	意义	法力	机能
用处	用途	用场	用
实效	证验
特效	神效
副作用	负效应
反应	影响	反响	反射	感应	反馈
反作用	反动
名声	名气	声名	名誉	声誉	信誉	誉	名	声	望	声望	孚	声价
名望	美誉
盛名	大名	美名	久负盛名	享有盛誉	小有名气
众望	人望	得人心
骂名	秽闻	恶名
虚名	浮名
声威	威名	威望	威信
情面	人情	脸面	面子	脸皮	情	份	老脸	老面皮	老面子
面子	体面	面目	脸面	颜面	颜	脸	大面儿
势力	势
权势	威武
恶势力	魔爪	铁蹄	腐恶	魔手
威风	威严	威势	威	虎威	雄风	雄威
气势	势	声势	气魄	气焰	势焰
锐气	锐
凶焰	凶气	气焰	敌焰
笔力	骨气	风骨
事物	物	东西
对象	目标	靶子	靶
原因	因	故	缘故	原故	原委	原由	缘由	因由	来由	根由	由	由头	由来	来头	案由	青红皂白
起因	缘起	导火线
情由	事由	情有可原	事出有因
病因	病源	病根
祸根	祸端	祸胎
结果	后果	果	结局	究竟	分晓	下文	产物	名堂
报应	报	因果	因果报应
恶果	苦果	兰因絮果
根源	本源	渊源	起源	滥觞	根	根子	根苗	溯源	源自
源头	源流	源
来源	源	泉源	源泉
水头	水源
证据	左证	证	信	凭	据	凭证	凭据	信物
明证	铁证	确证	信据	实据	真凭实据	有根有据	有理有据
根据	依据	凭依	据
论证	论据	实证	立据
指针	南针	指南针
借口	由头	托词	饰词	口实	端	故	挡箭牌	托辞	遁词	为由
理由	理	说辞	说头儿
把柄	辫子	小辫子	榫头
笑柄	笑谈	笑料
话柄	口实	话把
典故	典	古典	掌故
出典	出处
目的	鹄的
宗旨	大旨	要旨	主旨	宏旨	弘旨	旨要	旨	宗
规律	法则	公例	公理	原理	常理	公设
定律	定理
经济规律	经济法则
自然规律	自然法则
逻辑	论理
道理	理路	事理	理	谛	所以然
大道理	大义	义理
真理	真谛	真知
正理	公理
歪理	邪说
正义	义	公道
天理	天道
教义	佛法	福音
玄机	玄	堂奥	禅机
情理	物理	大体
世情	人情	人情世故
死理	一面儿理
意义	义	意思	含义
定义	界说	概念
蕴意	意蕴
内蕴	内涵
头绪	头脑	端绪	端倪	眉目	线索	有眉目	初见端倪
条理	条	脉络	条贯	板眼	伦次	系统	理路	眉目
思路	笔录	构思
笔法	笔路	笔势
立场	立脚点	立足点
角度	观点	出发点	视角	着眼点	落脚点
就业观	择业观
方法	法子	办法	点子	主意	法门	章程	抓挠	道道儿	长法	方	法	术	智	辙	道	计	了局	措施	艺术	不二法门	方式	解数
常轨	常规	套套	框框
兵法	韬略	战法	阵法
障眼法	遮眼法	掩眼法
反证法	归谬法
花点子	花花点子
茶道	茶艺
灸	腌
集约经营	集约
诀窍	诀要	窍门	门槛	诀	秘诀	奥妙	三昧	门路	门道	门径	技法	妙诀	要诀	妙法	良方	妙方
步骤	步调	步子	手续
关系	瓜葛	干涉	干系
群众关系	人缘儿	人头	人缘
友谊	情谊	交谊	交情	友情	情分	交	谊	义	雅
老交情	旧交	故交
深情	鱼水情	鱼水	血肉	骨肉	厚谊	深情厚意	亲情	军民鱼水深情	手足之情	赤子情	亲缘	直系
深交	至交	忘年交	莫逆之交	忘年之交	忘年情
私交	私情
邦交	国交
缘分	因缘	姻缘	缘	机缘	情缘
形状	样子	形态	形象	形制	造型	模样	样	形	状	相	貌	象	状貌
怪相	奇形怪状	怪模怪样
地形	地势	形势	势	形	山势	地貌
体形	身段	身材	体态	身条
条形	线形	带状
多边形	多角形
三角形	三角	三边形	三边
菱形	口形	斜角
正多边形	正多角形
几何图形	图形	空间图形
棱锥台	棱台	台式
圆锥台	圆台	圆锥
圆圈	圈子	圈	周	匝	旋	环	圆形	环子	线圈
状态	态
式样	样式	形式	式	花样	款式	式子	试样	样款	款型
时样	时式
排比	排偶
惨象	惨状	痛苦状
密闭式	封闭式
装饰	装璜
风景	景色	景致	景	色	山水	风光	光景	风月	风物	景物	景点	景观	山色	青山绿水	山山水水	山光水色
春光	春色	韶光	韶华	蜃景	春暖花开
秋景	秋色
晚景	夜景	夜色	暮色	曙色	野景
旧景	旧貌
青山秀水	清山秀水
名胜古迹	胜迹
景象	现象	气象	状况	情景	光景	面貌	场面	容	观	景	万象	场景	此情此景	形貌
美景	良辰美景
幻境	幻影	春梦	幻梦	镜花水月	幻景	幻像
村容村貌	村容
新气象	新景观	新貌
容貌	相貌	面貌	品貌	外貌	貌	容	相	面相	长相	形相	面容	姿容	容颜	眉眼	眉目	面目	模样	样子	形容	仪容	脸子	眉宇	眉睫	脸相	真容	原样
美貌	红颜	姿色	冶容	人才	花容玉貌	一表人材	媚颜	丰姿	兰花指	浓眉大眼
姿势	姿	姿态	架势	架式	架子	功架	式子	相
雄姿	英姿	飒爽英姿
婀娜多姿	摇曳多姿	多彩多姿
步伐	步履	脚步	步子	步
退步	后步
方步	四方步	八字步
装束	打扮	妆饰	扮相
艳妆	靓妆	浓妆艳抹
仪表	仪容	仪态	仪观	仪	人品
神情	神色	神气	神采	表情	神	容	色
态度	姿态	神态	情态	千姿百态	态势
言谈	辞色
眼色	眼神
眼光	目光	眼神	眼波	秋波
脸色	面色	气色	声色	眉眼高低	眉高眼低
笑容	笑脸	笑颜	笑貌	笑影	一颦一笑
喜色	喜气
愁容	愁云	苦相	愁眉苦脸	忧容
怒容	怒色	怒气	脸子
凶相	煞气	杀气
惧色	惊魂
醉意	酒意
美色	女色	媚骨
风度	风采	风仪	风姿	风范	仪态	标格	容止	气概	气度	气宇	神宇	气质	气派	派头	势派	丰采	风韵	神韵	威仪
骨气	风骨	侠骨	傲骨	铁骨
豪气	英气	浩气	气慨
骄气	傲气
书卷气	书生气
性质	习性	特性	属性	性能	性	机械性能	通性	总体性
趋光性	慕光性
准确性	准头
可能性	可能
音质	音色	音品
生产经营性	营业性	业务性
紧缩性	伸缩性	压缩性
预见性	前瞻性
广泛性	普及性
不确定性	可变性
诱导性	诱惑性
革命性	探索性	开拓性	批判性
指导性	指令性
背日性	背光性
流动性	流通性
试验性	实验性	试错性
紧迫性	迫切性
敏感性	过敏性
趋向性	趋利性
条理性	逻辑性
礼节性	象征性
鼓动性	拉动性
可持续性	延续性
可操作性	操作性
自营性	自主性
永久性	永恒性
局部性	区域性
优点	长处	长	瑜	独到之处	可取	亮点	长项	强点	助益
各有所长	学有所长
缺点	缺欠	欠缺	缺陷	短处	短	瑕疵	疵瑕	瑕玷	毛病	通病	症结	瑕	疵	弱点	弱项	先天不足	疵点	败笔	老毛病
益处	好处	利益	裨益	补益	便宜	益	补	裨	利	润	实益	功利	进益	义利
现成饭	渔人之利	渔翁得利	大幅让利
微利	蝇头微利	小便宜	单利
功名利禄	名利
害处	坏处	弊端	弊病	流弊	弊	时弊
积弊	宿弊	无私有弊
切身利益	既得利益
利弊	利害	得失	成败利钝	优缺点
特征	特点	特性	特色	风味	表征	性状
差别	别	区别	出入	差异	异样	歧异	差距	距离	千差万别	反差
上下	高低	优劣	好坏	三六九等	天壤
天壤之别	霄壤之别	相去甚远
存小异	存异
范围	范畴	规模	框框	圈圈	局面	界	面	圈	层面
势力范围	地盘	租界
手心	掌心	手掌	手掌心	魔掌	牢笼	樊笼
省里	省内
火力网	火力圈
通篇	全文	满篇	全篇
辖区	管区
方面	上面	上头	地方	方	面	点	端	者
处处	各方
领域	天地	园地	圈子	世界	小圈子
界	林	苑	坛	系统	战线
一方面	一边	一端	一面	一头	单方面	单	另一方面	一派	单向
双方	双边	两下里	两头	两边	两	双面	彼此	二者	两岸	两端	两面	两手	两者
多方面	多边	多方	多头	绝大部分	大端	大举
官场	宦海	政界
文学界	文坛	文苑
文艺界	艺苑	艺林	艺界	艺坛
诗坛	书坛
学界	知识界	科学界	教育界	学术界	科技教育界	文化界
借方	收方
戏曲界	梨园
贷方	付方	买方	借贷方
着力点	着力处
前端	前者
负面	阴暗面
商业界	商界
汽车界	汽车业界
各界	各行各业
工商界	工商企业界
社科界	社会科学界
环节	环
系统	系	体系	网
血统	血缘	血脉
分系统	子系统
合作网	协作网
互联网	互联网络
观测网	监测网
互联网	计算机网
管网	管道网
种类	类别	品类	类型	门类	部类	项目	品种	花色	色	种	类	列	路	档	型	档次	档级	品目
物种	种
新品种	新品
此类	该类
雌雄同体	雌雄同株
雌雄异体	雌雄异株
低高型	高低型
研究型	科研型
结构	构造	组织	布局
班子	架子	领导班子
梯队	梯级
建制	体制	编制
次序	次第	程序	顺序	次	序	第	先后	先来后到	主次
词序	语序	语次	音序
席次	座次	坐次	位次
层次	层系
排行	行	横排	排名	排名榜
流水线	流程	工艺流程
头一回	首轮	首度	首次
下一场	接下来	然后
本次	此次
白班	日班
行列	行	列	排	班	队	阵	队列	序列
一行	一条龙	一溜儿	一人班	单排
雁行	雁阵
工薪层	工薪阶层
表面	外表	外部	大面儿	表	标
门面	伪装	外衣	画皮	假面具	假相	糖衣	门脸儿
实质	精神	本质	本相	本色	真相	原形	面目	真面目	本来面目	庐山真面目	实为
根本	基本	本	基础	基业	基石	木本	水源	内核
关键	症结	关子	关节	节骨眼	要点	要害	问题	焦点	枢纽	枢机	刀口	点子	纲	纽带	主焦点	典型	热点
地心	地核
核心	中心	重心	本位	重点	基点	主脑	主导	主体	主心骨	关键性	着重点	基本点	第一性	侧重点	重头戏	当轴处中	择要
中枢	心脏	灵魂	命脉
因素	要素	元素	素
成分	分	成份
水分	潮气
养分	营养	滋养	肥分
标准	基准	准绳	绳墨	准	法	谱	极	准谱儿	定准	规则	规范	条件	原则	尺度	尺码	准星	格木	参考系	标准化	规格	格	口径	尺度
准则	信条	训	圭臬	格言	楷则
榜样	样板	样子	旗帜	规范	楷模	典范	规范	范	师	法	则	体统	金科玉律	指南	楷
好榜样	表率	模范	楷范
师表	师范	为人师表
垂范	典型
质量	品质	质	质地	身分	色	成色
水平	水准	程度	档次	品位
高质	质量上乘
基础	根基	根底	功底	底工	底子	幼功	基本功	底蕴	础
界限	界线	分界	界	分野	鸿沟	壁垒	格	线	边境线
只限	限于
下线	底线
限度	限	度	止	边	止境	底止	限止	界限	穷尽	尽头	无尽	底限
顶点	顶峰	极限	极点	极端	终极	终点	顶	极	终端	尖峰	巅峰
极致	极了
阴极	负极
正极	阳极
分寸	尺寸	深浅	轻重	高低	大小	轻重缓急	大大小小
分量	斤两
力气	气力	劲头	劲	力	巧劲	马力
死力	死劲儿	后劲	牛劲	傻劲儿	忙乎劲儿	劲儿
体力	膂力
脚力	脚劲	腿脚
人力	人工	力士
大力	鼎立	量力
绵薄	犬马之劳	余力	鸿蒙
力量	力
生命力	活力	精力	生气	生机	元气	血气	生机勃勃	肥力
劳力	劳动力	半劳动力	全劳动力	壮劳力
视力	目力	眼力	眼神
财力	资力	物力
兵力	军力	武力
武力	暴力	强力	淫威
法力	佛法
反冲力	坐力	后坐力	反作用力
附着力	黏着力
引力	吸力	吸引力
地心引力	重力	地力	地磁力	磁力
万有引力	引力
拉力	张力
旁压力	侧压力	下压力	上压力	压力
内聚力	凝聚力
笔力	骨力
蓬勃生机	勃勃生机
运力	加力	载力
能量	能
势能	位能
热能	热量	汽化热	潜热
核子能	核能
名称	名目	名号	称号	称呼	称谓	称	名	号
美名	美称	英名	雅号	徽号
尊称	大号
爱称	昵	亲爱的
别称	又称
俗称	俗名
名目	名堂
名义	名
幌子	招牌	牌子	旗号	金字招牌
牌子	牌	商标	标记	牌号	招牌
曲牌	牌子	牌	词牌	诗牌
标题	题目	题名	题
副标题	副题
罪名	帽子
姓名	全名	真名	现名	人名
姓	姓氏	氏	百家姓
复姓	双姓
贵姓	尊姓
名字	名	讳
大名	芳名
表字	字
小名	乳名	奶名
假名	化名
别名	别号	别字	号
外号	绰号	诨号	诨名
客姓	外姓	异姓
生肖	属相	十二生肖	十二属相	十二属
性别	性
籍贯	籍
原籍	祖籍	老家
户籍	户口
川籍	四川籍
资格	身价	身份
出身	身家	家世	门第	门户
辈分	行辈	辈	世	代	辈数	年辈
吾辈	吾侪
平辈	同辈
上辈	长辈	前辈	先辈
下辈	小辈	晚辈	后辈	小字辈
体格	腰板儿	身板	身子骨儿	筋骨	体魄
身体	人
性格	性情	心性	性子	性	秉性	性灵	脾气	气性	脾性	禀性	人性	性气
天性	个性	秉性	赋性	本性	生性
牛脾气	牛性	牛劲	牛气	我行我素
老脾气	故态
孩子气	稚气
品行	品性	品格	品德	德	操守	操行	风操	风骨	行止	操	情操
人格	人品	人头	人	品质	质地	格调	灵魂	为人
高风亮节	德艺双馨	诚信
道德	德行	德	道	道义	德性
美德	贤德	贤惠
妇道	三从四德
作风	气	架子	气派	派头	主义	官气	作派
阔气	阔	排场	场面	外场
平均主义	大锅饭	集体主义
利己主义	个人主义
伦常	人伦	五伦	五常	天伦	伦	伦理
孝道	孝	孝心
节操	节	气节	名节	品节
大节	大德
贞操	贞节
胆量	胆力	胆	胆子	勇气	种	胆气	胆略	心胆
魄力	气魄	魄	胆魄
血性	血气
气量	器量	度量	量	心气	度	心胸	心路	心地	心眼儿	胸襟	胸怀	襟怀	肚量
海量	洪量	雅量
气概	骨气	气	斗志	士气
侠骨	铁骨
智慧	智	慧	慧心	智力	灵性	智商	灵气
天资	天才	天分	天赋	天禀	禀赋	材	资质
心窍	心劲	悟性	理性
才智	聪明才智	智谋	才分	才思	智略	脑汁	神智
才能	才力	才干	干才	才略	才	经纶	才识
才华	才气	才情	才略	文采	头角	风华	词章	德才
奇才	雄才	雄才大略
口才	辩才
文才	笔墨	笔底下	生花之笔	生花妙笔
本领	本事	身手	能耐	能事	能
技术	技能	技巧	技艺	技	艺	术	招术
神通	三头六臂	神功
特长	专长	绝技	绝招	一技之长	拿手好戏	看家本领	杀手锏	绝活	绝艺	拿手戏	两下子	蹬技	奇绝
武艺	本领
舞技	舞艺
球技	球艺	控球技术
高技术	高新技术
战技术	战术
能力	力量	力
记忆力	记性	耳性
眼力	眼光	慧眼	鉴赏力	观察力
功夫	功力	功	素养	造诣
修养	涵养	教养
思想	思	思维	心理
思想意识	观念	价值观	传统	绝对观念	历史观
精神	魂	气	魂儿	精神上
心思	情思	神思	心神	心肠	神魂	思绪	思潮	心潮
脑子	脑	脑力	头脑	脑筋	脑瓜子	灵机	枯肠	心力	心血	心机	血汗
脑海	脑际
意匠	匠心	心裁	机杼	机心
思路	思绪	文思	笔触
上进心	进取心
警惕性	戒心	警惕心
信心	信念	自信心	信心百倍
忌妒心	妒忌心	醋劲儿
感想	感	感触	感受
内心	心里	心	胸	衷	心头	心坎	心房	心魄	心弦	心中	中心	心灵	心扉	心神	心髓	心迹	心底	心目	心尖	心田	心地	心肠	良心	私心	心曲	心眼儿	方寸	寸心	寸衷	衷心	胸臆	肺腑	满心	心窝子	六腑	心心
居心	用心	存心	心气	心术	心眼儿	心路	用意	城府
心事	心曲	下情	衷情	衷曲	苦衷	隐衷	隐情	隐私	隐	苦	难言之隐
恻隐之心	慈心
良心	人心	灵魂	心肝	良知
丹心	赤心	红心	忠心	公心	赤子之心	童心	真心	腹心	心腹	诚心	诚意	至诚	热血	真情	情素	肝胆	悃	实心实意	真心实意	诚心诚意	忠贞不渝
私心	私念	私	私心	杂念	私心杂念
邪心	贼心	邪念	妄念	非分之想
外心	异心	贰心	二心
黑心	恶心	恶意	祸心	叵测之心
感觉	知觉	神志	感	感性
味道	滋味
同感	共鸣
感情	情愫	情	情感	情义	幽情	真情实意	结	底情	情丝
常情	人情	人之常情
心意	情意	寸心	意思	忱	意
本心	本意	原意
好心	善心	好意	善意	美意	爱心
厚意	雅意	盛意	盛情	深情	深情厚意	敬意
谢意	谢忱
歉意	歉
假意	虚情假意	敌意
心情	情绪	心境	心气	心绪	意绪	心思	心怀	情怀	心态	心气儿
豪情	激情
民情	群情	人心	民心	民意	民情	下情	公意	民心向背
世情	人情	世态	人情世故
亢奋	激奋
爱情	情爱	情意	柔情	痴情	爱恋	情网	情	爱意	旧情	含情脉脉
春情	风情	色情	春心	春意	醋意	情窦初开
苦心	苦口婆心
忧心	忧虑	忧愁	愁肠	愁绪	虞
心病	隐痛	隐忧
怒火	怒气	火气	火头	火	气	怒	闲气	心火	肝火	无明火	虚火
众怒	公愤	民愤
不平	夹板气
怨气	怨	怨恨	怨尤	怨艾	嫌怨	哀怒
幽怨	幽愤
宿怨	积怨
欲望	欲念	欲	私欲
情欲	人事	性欲	肉欲	春	情
需要	需求	要求	求	需	急需
指望	希望	盼头	想头	巴望	望	重托
愿望	希望	心愿	意愿	誓愿	愿	意	意思	寄意
志愿	志
夙愿	素愿	宿志	宿愿	宏愿	夙	愿心	真意
初愿	初衷
意图	图	企图	打算	意向	用意	作用	意	来意	表意
意旨	旨意	意志	法旨	心意	旨在
计划	规划	计	方略	蓝图	稿子	打算	算计	猷	谟	谱儿	线性规划
大计	鸿图	弘图	雄图	雄图大略	百年大计
小九九	如意算盘
计策	策略	谋略	对策	策	谋	计谋	机谋	智谋	权谋	机关	机宜	心计	心路	预谋	远谋	策略性	谋计
权术	智术
韬略	战略	战略性
巧计	妙计	神机妙算	锦囊妙计	良策	妙策
上策	万全之策
阴谋	诡计	阴谋诡计	奸计	狡计	鬼胎
毒计	毒谋	恶计
故智	故伎	老一套
手段	手腕	手法	手眼	招数	招	一手	权术	伎俩	心数	心眼
高招	绝招
花招	把戏	噱头
花头	花枪	花样	鬼把戏	怪招
冷箭	暗箭	阴着儿	鬼蜮伎俩	伎	明枪暗箭
辣手	毒手	黑手
理想	志向	志	抱负	心胸	雄心	壮志	雄心壮志	豪情壮志	远志	笃志	壮心	素志	大志	报国志	扶志	胸怀大志	有志于	雄心勃勃
幻想	空想	玄想	痴想	妄想	白日梦	美梦	春梦	痴心妄想	做梦	理想化	臆想	奇想	随想
泡影	梦幻泡影	黄梁梦	南柯一梦	一枕黄粱	南柯梦	黄梁美梦	黄粱梦	黄粱一梦	黄粱美梦
梦幻	梦乡	梦境	梦	睡梦	梦寐	迷梦	睡乡	梦见
噩梦	恶梦	梦魇
志气	意气	心气	斗志
意志	心志	毅力	恒心	气	定性
干劲	劲头	闯劲	钻劲	拼劲	冲劲	实劲
兴趣	兴味	志趣	趣味	兴	感兴趣
兴致	兴会	兴头	意兴	心思	劲头	劲	来头	胃口	谈兴	游兴	余兴
意气	气味	口味	脾胃
乐趣	生趣	意趣	意	趣	童趣	异趣	野趣	旨趣
诗兴	诗思
嗜好	爱好	喜好	癖好	癖	癖性	痼癖	各有所好
瘾头	瘾
情致	致	趣	情趣	趣味	意趣	天趣	意味	意思	别有情趣	看头
韵味	韵致	风味	风致	韵味儿	情韵	气韵
余韵	遗韵
想法	想头	念头	念	思想	意念	动机	心思	心劲	胸臆	遐思
主意	主见	主心骨	主	意见	呼声	呼吁	主张
坏主意	馊主意	鬼点子	坏	花花肠子	小算盘
见解	见识	见地	看法	意见	眼光	观点	观	见	意	理念	视角
卓见	灼见	高见	远见	真知灼见	远见卓识	卓识
创见	新意	创意
定见	定盘星	一定之规	准谱
浅见	管见	拙见	私见	一得之见	一得之愚
成见	入主出奴
偏见	偏	门户之见	一孔之见	一隅之见	一般见识
异议	异言	异词	异同	异端	疑念
人生观	世界观	宇宙观
精华	菁华	精髓	粹	精粹	花
宝贝	宝物	法宝	宝	瑰宝	传家宝	国粹
财富	遗产	宝藏
毫毛	鸿毛	鹅毛	纤毫	涓滴	秋毫之末
赘疣	蛇足	附赘悬疣
糟粕	草芥	粪土	沉渣	残渣	残余	余烬	遗毒	流毒	残渣余孽	污泥浊水
枯木朽株	僵尸
萌芽	胚芽	幼芽	幼苗	嫩苗	苗子	新苗	苗	萌
朝露	昙花
空架子	泥足巨人	绣花枕头
大杂烩	杂烩	杂拌儿
阻力	阻碍	障碍	拦路虎	绊脚石
屏障	屏蔽	遮挡	掩蔽	隐身草	遮羞布	烟幕弹	障子	风障	篱障
挡风遮雨	遮风挡雨
枷锁	约束	管束	束缚	羁绊	桎梏	紧箍咒
诱饵	糖衣炮弹	糖弹
圈套	钩	牢笼	陷阱	骗局
护身符	护符	保护伞
途径	路径	门径	蹊径	路	门路	门道	路线	路子	路数	不二法门	干路
道路	道	途程	征途	征程
长征	万里长征
正路	正道	正轨
坦途	阳关大道	康庄大道
邪路	邪道	歪门邪道	旁门左道	左道旁门	歪道	歪路
后门	方便之门
歧路	歧途	迷津
老路	覆辙	套路	套数
绝路	末路	死胡同	穷途末路	死路
近路	捷径	终南捷径
半路	半途	中途	中道
后路	后手	余地	退路	逃路
阶	阶梯	台阶
敲门砖	垫脚石
致富线	富民路	致富路
神	神仙	神人	神物	神道	神明	神灵	菩萨	仙人	仙
造物主	上帝	天	天神	天公	苍天	上天	皇天	老天爷	真主	盘古
女神	神女	仙姑
仙女	仙子	天仙
圣母	娘娘
天使	安琪儿
上帝	耶和华
基督	耶稣	救世主
佛陀	佛	佛爷	浮屠	阿弥陀佛	弥勒佛	强巴阿擦佛
西王母	王母娘娘
观世音	观音	送子观音
财神	财神爷	赵公元帅	过路财神
阎罗	阎王	阎罗王	阎王爷
土地	土地老	土地爷
灶神	灶君	灶王爷
凶神	凶神恶煞
鬼	鬼魂	死鬼	异物
魔鬼	魔	撒旦	鬼魔	鬼神	死神	厉鬼
恶鬼	魔王
妖	妖怪	妖精	妖魔	邪魔	妖物	怪物	精	怪	精怪	精灵
狐仙	狐狸精	异类	异物	白骨精
魂	魂灵	灵魂	魂魄	神魄	心魂
阴魂	幽魂	幽灵	亡灵	亡魂	鬼魂	在天之灵
英魂	英灵	忠魂
妖魔鬼怪	魑魅	魍魉	魔怪	鬼怪	鬼魅	鬼蜮
神怪	神异
天国	天堂	上天	净土	西天	西方	极乐世界
天宫	玉宇
月宫	蟾宫
龙宫	水晶宫
阴间	阴曹	冥府	黄泉	九泉	九泉之下
前生	前世	上辈子
来世	来生	下世	下辈子
龙	苍龙	龙身	鸟龙
蛟龙	蛟	飞龙
虬龙	虬
凤	凤凰	百鸟之王	凰	金凤凰	鸾
麒麟	麟
世界	世	世上	大地	天下	天底下	全世界	环球	全球	举世	中外	寰宇	五洲	海内	海内外	五湖四海	大千世界	大世界	普天之下
第三世界	第三国际
人间	人世	人世间	世间	阳间	尘世	尘寰	尘俗	红尘	尘	凡	下方	浊世	花花世界	凡间	江湖
国家	国	邦	国度	江山	社稷
全国	通国	举国	举国上下
中原	华夏	中华	华	赤县	神州	九州	赤县神州	炎黄	中国	礼仪之邦
盟国	盟邦	盟友	联盟	同盟国	友邦	盟军
外国	外	外域	异国	异邦	异域	夷	别国
邻国	邻邦
万国	列国	国际
大国	泱泱大国	雄	强	强国	超级大国	大公国	列强
共和国	民主国
王国	帝国	君主国
主权国	独立国	独立国家	独立王国
属国	藩国	藩属	藩	附属国	附庸	殖民地	所在国	债务国	债权国
联邦	邦联	阿联酋	合众国
本国	我国
省	省份	省区
县	邑	旗	宗	版纳	县城	县份	试点县
乡	镇	乡镇	民族乡	乡乡镇镇
我省	本省
本县	我县
东洋	东瀛	支那
各州	全州
地县	市县
首都	国都	京都	都城	京城	上京	京	都	京师	京华	凤城	北京	北京市
故都	旧都	旧国
省会	省城	首府	省府
人种	种族	种
民族	族	全民族	部族	中华民族
外族	异族	异教
蒙古族	蒙族
哈萨克族	哈萨克
客家人	客家
门巴	门巴族
家族	亲族	家门	族	宗	房
皇族	皇室	皇家	金枝玉叶
王室	王族
望族	世族	世家	大家	门阀	权门	豪门	名门	朱门
大族	大户	大姓	大家族
门第	门户	门楣	家门	门	户
家庭	家园	人家	家	门	家家	家中
全家	合家	阖家	一家子	本家儿	全家人
书香人家	诗礼之家	书香门第	诗书门第
寒门	柴门	蓬门荜户	蓬户瓮牖
娘家	岳家
婆家	人家
住户	人家	户	家	人烟	宅门	每户	住家	居家	村户
农户	庄户	农家	农户家
富户	首富	豪富	大户	富裕户
小康	小康户
小户	小户人家
舍间	舍下	下家	寒门	寒舍
单门独户	独门独户
户头	户
阶级	阶级性
无产阶级	工人阶级
政党	党	党政
共产党	共	党	中共	中国共产党	国共
政治	政	法政
朝政	时政	政局	大政	党政	宪政	国政	新政
仁政	德政	王道
暴政	虐政	苛政	霸道	霸气
帝国主义	帝
法西斯主义	法西斯
机会主义	冒险主义
帝制	君主专制
议会制	代议制	多党制
专政	独裁
政策	策略	策	国策	方针	同化政策
制度	制	社会制度
国际公制	公制	米制	国际制
市制	市用制	土制
征兵制	军制	兵役制
募兵制	志愿兵制
所有制	国体
个体所有制	个体户	私人占有制	非公有制
非公有	非国有
三资	三资企业
国有	公有
体制	建制	编制	单式编制	机制
机构	组织
部门	单位
会计室	帐房	财务科
教研室	教研组
工段	段
核查组	检查组	调查组
维修班	修理班	抢修班
专修班	研修班	进修班
春蕾班	女童班
辅导班	补习班
训练班	培训班
研讨班	研习班	讲习班	研究班
支部	分支部
关系部	公关部
团体	组织	集体	伙	社	团	团队	团伙	集团	团组织
阵营	阵线	营垒	同盟
红十字	红新月会
群落	部落	群体
黑社会	黑帮
本社	我社
派别	派系	宗派	门户	山头	流派	派	家	宗	门	帮派	船帮	法家
嫡派	嫡系	正宗	正统派
支派	支系	分支	旁支
左派	左翼
右派	右翼
军队	武装部队	武装力量	武装	部队	队伍	人马	大军	三军	军	师	旅	戎	枪杆子	武力	行伍	兵马	军事	枪杆	军旅
雄兵	雄师	重兵	天兵	铁流	劲旅	坚甲利兵
貔貅	貔虎
海军	水军	水师
伞兵	空降兵
子弟兵	国民军	人民军
解放军	人民解放军	中国人民解放军	红军	革命军
志愿军	中国人民解放军	八路军	八路
义师	义军	义勇军	共和军
卫队	禁军	御林军	近卫军	赤卫队	赤卫军	守军	自卫队	中军	清军	自卫军
前锋	先锋	先遣队	开路先锋
两翼	翼侧
援军	救兵	后援
战争	战事	战乱	战祸	烟尘	战火	烽火	烽烟	狼烟	兵火	兵燹	刀兵	兵戈	干戈	战	仗	乱	大战
战役	役
激战	苦战	鏖战	鏖兵	鏖斗
殊死战	死战	血战	硬仗
堑壕战	壕堑战
闪电战	闪击战
破击战	破袭战
初战	首战	此战
奋战	苦战
内战	内乱
宗教	教
道门	道	坛	道家
佛教	佛门	佛	空门	禅宗
天理教	八卦教
基督教	新教	耶稣教
天主教	旧教
东正教	正教
伊斯兰教	清真教	回教	伊斯兰	清真
婆罗门教	印度教
礼仪	仪式	仪	式	礼	典	典礼	庆典	仪仗
盛典	大典	国典
洗礼	洗
繁文缛节	殡仪
礼节	礼数	礼俗	仪节
礼貌	礼数	形迹	礼	无礼	多礼
虚礼	俗套	虚文
风俗	俗	风	习俗	民俗	风土	人情	风土人情	风俗习惯	传统	风俗人情	风土民情	谣风	遗俗
习惯	习气	积习	习
陋习	恶习	习染	沉痼	痼习	陋俗	固习	旧俗	旧习
风气	风尚	风	风习	习尚	新风
时尚	俗尚
家风	门风
世风	世道	世界	社会风气
妖风	邪气	歪风邪气	不正之风	歪风
地位	位置	身价	身分	位
要津	要路
高位	上位	青云	要职
名位	名分	排名分
职位	位置	职	岗位	哨位	职务
职守	职掌
差使	差事	职分
官职	功名	前程	乌纱帽	乌纱
岗	哨卡
等级	等第	等次	等差	级次	级差	等	级	号	流	路	阶	星等	品级	品	阶段
头衔	衔	职称	职衔
设计家	设计师
帝位	大宝	位	基	祚
爵位	爵
公爵	公
侯爵	侯	万户侯
伯爵	伯
子爵	子
男爵	男
事业	业
大业	伟业	宏业
行业	行	业	行当	本行	同行业	正业
七十二行	三百六十行	三教九流	九流三教	各行各业	五行	农工商
商业	商	生意	买卖	商贸	经贸	小买卖	小本生意	小本经营
工程	工	工事
水利工程	水利	水工	河工
土木工程	土木
职业	工作	营生	事情	生意	生业	饭碗	差事	事	业	差	专职
兼职	兼差	专兼职
工作	作业	业务	事务	事情	事体	务	政工
勤务	勤
总务	庶务	报务
野外工作	田野工作
活计	活路	活	生活	劳动	体力劳动	活儿
家务	家事	家务活
针线	针线活
手工	细工	手活
农活	农事	春事	庄稼活儿	农务
劳役	苦工	徭役	乌拉	赋役	徭役地租	苦差	苦活
动作	手脚	小动作
着数	招数	路数	招	招法
举动	行动	举措	举止	行径	一举一动	言谈举止	此举
善举	善事	善	好事	孝行	好斗
阴德	阴功	阴骘
恶	恶行	倒行逆施
私弊	藏掖	阴私	毛病
行为	行止	作为	行事	表现	行	所作所为	一言一行
暴行	横行	横逆	暴举
恶行	倒行逆施
权力	权柄	权	柄	印把子	权能	权位	权限	权杖
政权	政柄	大权	统治权	领导权
军权	兵权	王权
职权	事权
权利	权
财产权	产权	物权
责任	责	事	专责	义务	总责	权责	总任务
重任	使命	沉重	大任	千钧重负
职责	天职	职分	职掌	任务
本分	己任	本本分分
负担	担子	包袱
重负	重担	三座大山
会议	会	集会	议会
茶话会	茶会
党代会	党代表大会
代表大会	代表会
宴会	酒会	宴	便宴	家宴	歌宴
盛宴	国宴	鸿门宴	庆功宴
喜筵	喜酒	喜宴	满堂吉庆宴	婚宴
酒席	宴席	筵席	席面	席	筵宴	欢宴	酒宴
素席	素酒
规则	守则	准则	则	规	律	章法	轨道	清规戒律	规例	规约
章程	规章	条例	条条	章	例	典章
规定	规程
规矩	轨	绳墨	矩
常规	成规	定规	分规
空文	一纸空文
陋规	陈规	陈规陋习
条约	公约	约
协定	存照	协议书	协约	总协定
约据	契约
盟约	盟誓	宣言书
合同	合约
契	契据
保证书	保证	责任书
条款	条目	章	条规	条令	条文	条条框框
法律	法度	刑名	律	法	法网	王法	法规	法例
法制	法纪	纪纲	纲纪
宪法	宪	根本法	大法
法令	宪	政令	法案	法治
刑法	刑律	刑事
此法	本法
纪律	纪
禁	戒	禁例	律令
戒律	戒条	天条	清规戒律
罪行	罪名	罪过	罪	辜	孽	罪孽	罪恶	滔天大罪	弥天大罪	余孽	冤孽	作孽
刑罚	刑	徒刑
刑法	刑
从刑	附加刑
大刑	重刑	毒刑	酷刑	严刑
死刑	极刑	死罪	死缓
凌迟	剐
经济	财经	金融
上市	挂牌
价值	价	值
价格	价钱	标价	价	价位
行市	行情	盘子	盘	物价指数
价目	价码	报价
不变价格	比较价格	可比价格
产业	产	业	产业群
财产	资产	财
家产	家当	家业	家私	家事	家底	箱底	产业	家财	祖业
动产	浮财
不动产	恒产
私房钱	私房
财物	财	财富
钱财	资财	银钱	金钱	钱	财帛	赀	资	金	长物
洋财	横财	外财	傥
邪财	横财	不义之财
民脂民膏	血汗钱
资本	资产	资金	本金	基金	本钱	股本	老本	血本	本	财力	成本	工本
股份	股子	股	股金	股分
财政资本	金融资本	货币资本
垄断资本	独占资本
利润	赢利	盈利	利	赚头	创收	净收入	净利润	纯利润	实利
红利	花红	红
纯利	净利
股息	股利
利息	利钱	子金	利	息	利息率	收息率
年利	年息	年利率
月利	月息	月利率
高利贷	印子钱	印子
高利	重利
债务	债	帐
宿债	积欠
呆坏账	坏账
货币	钱币	通货	钱	币	圆	元	泉
纸币	钞票	钞	票	票子	纸票
辅币	补助货币	辅助货币
银元	银洋	洋	洋钱	光洋	现洋	现大洋	大洋	花边	袁头	大头	鹰洋	金元	银圆	元宝
角票	毛票
铜元	铜钱	铜板	小钱	铜钿	钱	子	文	铜币
大钱	大
金条	条子	黄鱼
银两	银子
票据	票	券
汇票	外汇券	券别
印花税票	印花	税票
邮票	邮花	纪念邮票
联运票	通票
有价证券	证券
奖券	彩票
公债券	债券	国债券
捐税	捐	税	课	花消	税金	税捐	税款	税利	税收	税赋
田赋	钱粮	租
苛捐杂税	苛杂
租金	租	租税
工资	工钱	工薪	薪资
薪水	薪金	薪给	薪俸	薪	薪饷
月薪	月工资
军饷	饷	粮饷
俸禄	禄
津贴	补贴	贴
报酬	酬劳	酬金	待遇
工钱	手工钱
稿费	稿酬	版税
润笔	润资
佣金	佣钱	佣	花消	回扣
脚钱	脚力
帐目	账	账面	账目
日记帐	日记账
明细帐	细帐	明细账	细账
款项	款子	头寸	款	钱	项	帐
公款	帑
现款	现钱	现金	现钞	码子	现
进项	进款	收入	收益	纯收入	入账	创汇	获益	低收入
收支	进出
盈余	赢余	余剩	剩余	结余	存栏	存项
亏损	亏空	赤字	窟窿	下欠	尾欠
损耗	亏耗	消耗	伤耗
损益	盈亏
公积金	公共积累
罚金	罚款
存款	储蓄
头寸	银根
外快	外水
保证金	保险金	抵押金
赔偿金	赔偿费	补偿费	补偿金
补助金	补助费
成本费	工本费
修理费	维修费
通话费	电话费	话费
代理费	代办费
教育事业费	教育费
费用	费	用	用度	用费	花费	用项	支出	开支	开销	花消	花销	资费
生活费	日用	家用
伙食费	膳费	饭钱	餐费
学费	学杂费
邮费	邮资
路费	旅费	盘缠	川资	旅差费	差旅费
车钱	车马费	交通费	车费
运输费	运费
小费	茶钱	茶资	酒钱
赏钱	喜钱
零用	零花	零钱	月钱	零花钱	零用钱	零用费
抚恤金	恤金	优抚金	慰问金
文化	文明	双文明
仰韶文化	彩陶文化
教育	教	教养
电化教育	电教
兴学	办学
卫生	保健
学说	主义	思想	理论	论
马克思列宁主义	马列主义
唯物主义	唯物论	唯物
历史唯物主义	唯物史观
唯心主义	唯心论	唯心
形而上学	玄学
达尔文主义	进化论
中学	国学	旧学	东方学
学问	学	墨水	学术
知识	知	学问	学识	文化
见识	见闻	识	耳目	眼界	胆识	所见所闻	有胆有识	视界	学海	识见
科学	学
社会科学	人文科学
逻辑学	论理学
音韵学	声韵学
语法学	文法学
医学	医术	医道
中医药学	中医学	中药学
学科	课	科目	课程	教程
语文课	国语课
数学课	算术课
理化	生化
外语课	外文课
体育课	体操课
医学	医
中医	国医
小儿科	儿科
牙科	口腔科
学业	课业	功课	作业
习题	练习	练习题
课外作业	家庭作业
题目	问题	题
考题	课题	考试题	试题
难题	偏题
考卷	试卷	卷子
号码	号子	号	码	码子	数码	编号
邮政编码	邮编
条形码	条码
记号	符号	号子	标记	标志	符	记	号
花押	押
杠子	杠
曲谱	谱	谱子
标点符号	标点
逗号	逗点	逗
句号	圈
顿号	点
感叹号	惊叹号
删节号	省略号
字	文字	文	言	契	仿	亲笔
汉字	中国字	方块字	单字	字
俗字	卜辞
古文字	古文	古字
简体字	简化汉字	手头字	简写
数目字	数字
金文	钟鼎文
大篆	籀文	籀
小篆	秦篆
隶书	隶字	今文
楷书	正书	真书	正楷	楷
朱文	阳文
白文	阴文
别字	白字
盲文	盲字
笔画	笔	画	笔划
横	画
竖	直	一直
挑	剔	提
捺	磔
偏旁	旁
宝	盖	儿	宝盖头
字母	假名
书体	字体	书	字
正体	正字
篆书	篆体	篆字	篆文	篆
隶书	隶
楷书	正楷	楷体	工楷	正字	正体	真
宋体字	老宋体	宋体
仿宋体	仿宋
草书	草体	草字	草	行草
小楷	小字
大楷	大字	寸楷
词	单词	字眼	字	单字
词语	用语	辞藻	辞
字句	词句
词组	短语
词汇	语汇
褒义词	褒词
贬义词	贬词
措辞	用语
冗词	冗词赘句
谚语	谚
语助词	语气助词
单纯词	单词
句	句子	语句	文句	词	句
佳句	妙句	绝句	清词丽句
名句	警句	语录	座右铭
语言	言语
汉语	华语	国语	中文	国文	汉语言
外国语	外语	外文
方言	土语	土话	地方话	白	白话
普通话	国语	官话
文学语言	标准语
文艺语言	文学语言
谜语	谜
令	酒令
题材	题目	问题
主题	正题	本题
体裁	样式	体	体制
布局	格局	布置
情调	色彩
格调	笔调	调子	调头
俗套	老套子	老调	窠臼
风格	风骨	标格	品格	作风
笔势	笔致	文笔
球路	歌路
音律	乐律
目录	目次	目	索引	引得
书目	书录
细目	子目
戏目	戏码	曲目
节目	剧目
内容	情节	情	本末	始末
细节	底细
字里行间	字字句句
意思	意
意味	寓意	味道	含意	命意
诗情画意	诗意
口气	口风	口吻	话音	语气	音	文章	言外之意	弦外之音
要点	要端	要义	要	要领	大要	中心	中心思想
摘要	撮要	提要
纲要	提纲	大纲	总纲	纲领
概要	梗概	概略	大概	大意	大旨	大校	大略	要略
话	言	语	谈	言语	言辞	说话	讲话	话语	语句	话头	口舌	唇舌	辞令
谈吐	措词	出言
谈锋	话锋
话头	话锋
片言	片言只字	只言片语	片言只语
至理名言	至理明言
豪语	豪言壮语
空话	空谈	侈谈	空论	空炮	白话	空头支票
牛皮	高调	大话	狂言	漂亮话
真话	真心话	实话	肺腑之言	由衷之言	心声	衷肠
知心话	私话	私语	私房话	床第之言
常言	常言道
家常话	家常
家乡话	乡谈
口头禅	口头语
客套话	客套	套子	套语	应酬话	寒暄语
门面话	官话	官腔
现成话	滥套子	老套子
俗话	俗语	常言	语	民间语
老话	古语
诺言	约言	诺	宿诺
誓词	誓言	誓
咒语	咒	符咒
口诀	歌诀
训词	训话	训	指示	训示
劝告	忠告
忠言	箴言	诤言	真言
遗言	遗教	遗训	古训
耳边风	耳旁风
婉言	婉辞	软语	好话	祝语
好话	感言	铮铮誓言
美谈	佳话
赞语	美言	客气话
祝词	贺词	颂词	口碑
笑话	玩笑	噱头	戏言
谗言	谗
清淡	玄
高帽子	高帽儿
甜言蜜语	花言巧语	迷魂汤	迷魂药
怨言	牢骚	怪话	闲话	微词	闲言闲语	冷言冷语	满腹牢骚
流言	流言蜚语	风言风语
胡话	妄语	瞎话	谬论	不经之谈
怪话	怪论	海外奇谈	奇谈怪论
谎话	谎	谎言	假话	鬼话	欺人之谈	弥天大谎
闲谈	闲话	闲扯
絮语	车轱辘话
赘言	废话	冗词赘句
粗话	脏话	下流话	猥辞	恶语	恶言
说白	道白	念白	白
引子	开场白
台词	戏词	戏文	词儿
回话	回音	回信
梦话	梦呓	呓语
急口令	绕口令	拗口令
口号	标语
切口	黑话	隐语	暗语
口供	供词	供	交代
寡言少语	少言寡语	寡言
一番话	一席话
此言	此话
说法	讲法	提法
言论	论	议论	谈话	发言
老调	滥调	陈词滥调	老生常谈
论调	调调
讲经说法	论道
评论	评说	述评	评述	评	阐
舆论	舆情	公论
众说	杂说	议论	街谈巷议
估测	测评	评测
建议	提议	动议	提案	决议案	建议书
结论	定论	断案	断语	敲定	谈定	下结论
决定	决议	定案
命令	命	令	号令	勒令
军令	将令
指令	训令	指示	训示	谕
圣旨	谕旨	旨意	诏书	上谕	旨	诏	敕	诰
兵符	符
通知	通牒	通报
布告	通告	通令	文告	告示	榜	榜文
檄文	檄书	檄
启事	告白	揭帖	字帖
喜报	报单
光荣榜	红榜
讣告	讣闻
报告	汇报	呈文	呈子	签呈	咨文	条陈
奏章	奏疏	章	表	本	疏	书
便条	条子	条	便笺
回条	回帖	回执	回单
招贴	招子
签	浮签	标签	标价签	价签	竹签
皮带	小抄儿
病假条	假条
处方	配方	方子	方	药方	方剂
单方	丹方	偏方	土方
成方	验方
说明书	仿单	说明
信	函	札	书	简	笺	鸿	翰	书信	信札	书札	书简	书函	尺牍	八行书	双鱼	鲤鱼	鸿雁	缄
家信	家书	竹报平安
来信	来函	来鸿
回信	复信	回音	玉音
贺信	贺函
手书	亲笔信
黑信	恐吓信
公函	文牍	授信
信件	函件	信稿
检举信	举报信
感谢信	表扬信	感谢状
邀请函	邀请信	邀请书
投诉信	上告信	信访件	上诉书
电报	电	报
传真电报	传真
加急电报	特急件
资料	材料	材	素材	骨材
文件	文书	文本	公文	公事	文牍	等因奉此
档案	档
案卷	案
卷宗	卷
照会	照
判决书	判词
悔过书	检讨书	检查
诉状	状子	状	起诉书
供状	供词	笔供	供
遗嘱	遗书
修改案	修正案
抄件	复印件	影印件
图	图形	图样	图片	图纸	图表	图籍
地图	地形图	地质图
正视图	正面图	主视图
侧视图	侧面图
顶视图	俯视图
频谱	频带
表	表格	报表
视力表	目力表
正误表	勘误表
坐位表	座位表
课程表	课表
作品	作	创作	著作	著	著述	撰述
巨著	鸿篇巨制	大作品	巨制
杰作	佳作	大作	雄文	神品	名著	大笔	大手笔	墨宝	绝唱	香花	压卷之作	绝响	名作	名篇	力作	大作品
处女作	出世作
拙作	拙笔	拙稿
急就章	即兴之作
遗著	遗书	遗墨	遗稿	绝笔	遗文	遗作
手迹	手笔	真迹	墨	墨迹
断编残简	片纸只字	残篇断简
文章	篇	章	篇章	成文	笔札	稿子
社论	社评
论文	舆论
八股文	制艺	时文	八股
札记	摘记	笔记	侧记
祭文	诔	悼词	哀辞	挽词	祷文	挽辞
碑文	碑记	碑志
墓碑	神道碑
墓志	墓志铭	铭文
行状	行述
文言文	文言	古文
白话文	语体文
应用文	实用文
记叙文	叙事文	叙文
说明文	论说文
骈文	四六文	诗作
上下文	前后文
辞章	词章
下卷	下篇
稿件	稿子	稿
草稿	草	稿	文稿	算草
初稿	未定稿	长编	原稿	原文
底稿	稿本	底	底子	书稿
书籍	书本	书	图书	书简	经籍	本本	书册	汉简	木简
丛书	丛刊	丛刻	文库
四库	经史子集	四书
历书	通书	黄历	老皇历	故纸
史书	史籍	史册	青史	史	汗青	竹帛	简本	简编	封志
兵书	兵符
古书	古籍	旧书
经书	经籍	经	经典	典籍	大藏经	真经	经卷
方志	地方志
集子	集
读本	课本	教科书	教本	教材	讲义
字帖	习字帖	帖
画帖	画谱
连环画	小人儿书	娃娃书	儿童书	小人书
书背	书脊
版本	本子	本	版
珍本	秘本	秘籍	孤本
样本	范本	模本	样书	样张
正本	原本	底本	底册	蓝本
副本	复本	抄本	写本	摹本	翻刻本
页张	页
封面	封皮	书皮	书面
报章	报纸	报
墙报	壁报
杂志	期刊	刊物	刊	报
周刊	周报
特辑	特刊	专辑	专刊	专号	专栏
报刊	报章杂志
书刊	书报
序言	序文	前言	题词	花序
引言	小引
导言	绪论	楔子
本文	正文	白文
结语	结束语	尾声	煞笔
跋	跋文	后记	书后
序跋	题跋
按语	按	案语	编者按	编者案
批语	批	批示	朱批
眉批	批注
引文	引语
注解	注释	注脚	注
凡例	例言
备考	备注
经典	经	经典著作
经文	经典	经	藏
佛经	释典	释藏	古兰经	圣经	十三经	金刚经	石经	六经	三字经
旧约	新约
文学	文艺
新文学	白话文学
口头文学	说唱文学	民间文学
小说	小说书	闲书
剧本	台本	脚本	本子	院本
散文	散记
小品	小品文
漫笔	随笔
传记	传	传略	事略	文传
杂记	笔记	笔录	笔谈	杂志	记	侧记
记录	记要	纪录	纪要
报道	通讯	简报	报导
日志	日记
图说	图鉴
纪行	游记	剪影	掠影
访问记	采访记
诗	诗歌	诗篇	诗文	诗抄	诗词	诗句	诗选	诗章
古体诗	古诗	古风	古
史诗	诗史
律诗	律
绝句	绝
旧诗	旧体诗
新诗	白话诗
民歌	民谣	歌谣	风	风谣	俚歌
儿歌	童谣
赞美诗	赞美歌	赞歌	颂歌
即兴诗	口号
词	长短句	乐章	歌词	鼓子词	宋词	繇
赋	辞赋
令	小令
曲	散曲	俳句
对联	楹联	联
门联	门对
对子	对
春联	桃符
音乐	乐
下里巴人	民乐
交响乐	交响诗
歌	歌曲	曲
情歌	恋歌
哀歌	悲歌
夯歌	号子
船歌	船夫曲
曲	曲子	乐曲
序曲	前奏曲	引子	过门儿
尾声	煞尾
小调	小曲
催眠曲	摇篮曲
戏剧	戏	剧
戏曲	曲
歌剧	歌舞剧	舞剧
话剧	文明戏
京剧	京戏	大戏
昆剧	昆曲
婺剧	金华戏
越剧	绍兴戏
粤剧	广东戏
豫剧	河南梆子
秦腔	陕西梆子
晋剧	山西梆子
闽剧	福州戏
评剧	落子
沪剧	申曲
淮剧	江淮戏
闹剧	笑剧	闹戏
武戏	武剧
木偶戏	傀儡戏	杖头木偶
皮影戏	影戏	驴皮影	影
看家戏	拿手好戏	保留剧目
唱段	选段
唱腔	腔调	声调
昆腔	昆曲
梆子腔	梆子
二黄	二簧
舞蹈	舞	俳
芭蕾舞	芭蕾
龙舞	龙灯
跑旱船	采莲船	大秧歌
太平鼓	羊皮鼓
电影	影戏	影	影片	影视	录像
无声片	默片
动画片	卡通	动画	卡通片	木偶剧
音像	声像
镜头	画面	映象
广角镜头	长镜头	慢镜头
大鼓	鼓书
铁板大鼓	铁皮大鼓
道情	渔鼓
莲花落	落子
说书	说话	评书	评话
评弹	弹词
滑稽戏	独脚戏	独角戏
河南坠子	坠子
杂技	把戏	杂耍
魔术	幻术	戏法
武术	国术	武艺	武工	拳棒	把势	把式	武
柔道	柔术
拳术	拳脚	拳
绘画	美术	图画	画图	丹青	画	图	美工	画片	图案	图腾	画画
插画	插图
国画	中国画
西洋画	西画
漫画	卡通
宣传画	招贴画
屏条	屏
木刻	木版画
字画	书画	墨宝	翰墨	册页
雕刻	雕像
塑像	泥塑	泥胎	塑像	微雕
佛像	佛
照片	相片	照	影	肖像	像
小照	小影
遗照	遗像	遗容	神像	真影
全家福	合家欢
像	形象	影像
画像	肖像	真影	写真	实像
疾病	病症	病魔	病痛	毛病	疾患	症候	病	疾	症	恙	疴
沉疴	沉痼	痼疾	顽症
急症	急病	暴病
险症	重症
绝症	死症	不治之症
瘟疫	疫病	疫疠	瘟	疫	疠
时令病	时令
并发症	合并症
内伤	暗伤
炎症	炎
结核病	结核	痨病	痨
精神病	神经病
性病	花柳病
梅毒	杨梅
贫血	血枯病
肺结核	肺病	肺痨
尘肺	灰尘肺
胸膜炎	肋膜炎
肝硬变	肝硬化
疟疾	冷热病	疟	疟子	出血热	登革热病	风疹
伤寒	肠伤寒
霍乱	虎疫	绞肠痧	痧
痢疾	痢
变形虫痢疾	阿米巴痢疾	银屑病
流行性感冒	流感
中暑	日射病	痧
对眼	斗眼
麦粒肿	针眼
青光眼	内障
白内障	内障
斑秃	鬼剃头
麻风	癞	小儿麻痹症	痹症
荨麻疹	风疹块
湿疹	湿气
白癜风	白斑病
癔病	歇斯底里
脑炎	大脑炎	暑瘟
癫痫	羊痫风	羊角风	痫
瘫痪	疯瘫
产褥热	月子病
阑尾炎	盲肠炎
流行性腮腺炎	痄腮
丝虫病	血丝虫病	粗腿病
鼠疮	瘰疬
高山病	山晕
疝气	小肠串气
呆小症	克汀病
走马疳	牙疳
不孕	不孕症	不育症
失眠病	失眠症
艾滋病	爱滋病
风湿	类风湿
甲亢	甲亢病
妇科病	妇女病
旧病	老毛病
牛瘟	烂肠瘟
黑穗病	黑粉病
黄锈病	黄疸	叶锈病
锈病	锈
外伤	金疮	创伤	伤口	疮	花
带伤	有伤
伤口	创口	口子	患处
肿瘤	瘤	瘤子	肉瘤
毒瘤	恶性肿瘤	癌	癌肿	癌瘤	癌细胞	根瘤	癌魔
癣	顽癣
头癣	秃疮	癞	瘌痢	癞癣
花斑癣	汗斑
手癣	鹅掌风
脚癣	脚气
疮	疡
疥疮	疥
痈	痈疽
疔	疔疮	疮
砍头痈	砍头疮
脓包	脓肿
疖子	疖
痂	疮痂
痔	痔疮
趼子	趼	胼胝
痣	痦子
癍	斑痕
寿斑	老人斑	老年斑
记	胎记
粉刺	痤疮
雀斑	黄褐斑
疣	肉赘	瘊子	赘疣	赘瘤	臀疣
疙瘩	圪塔	包	疹	块	肿块	疹子
茧	茧子	老茧
政府	内阁	阁	当局	朝
机关	机构	单位	部门
看守内阁	看守政府	过渡内阁
朝廷	宫廷	庙堂	王室	朝	廷	皇朝	清廷
官府	官厅	官署	官衙	衙门	衙署	衙	县衙	清水衙门
枢要	枢机
行政公署	行署	公署
大使馆	使馆	领馆	分馆
总领事馆	总领馆
总政治部	总政
计生委	计委
国家教委	教委
中央军委	军委
航天局	宇航局
国税局	税务局
林管局	林业局
物资局	国资局
邮电局	邮局
高法	最高人民法院	最高法院
检察院	人民检察院
法院	人民法院
法庭	庭
公安局	警察局	局子	派出所	公安部	警方	巡捕房	警署	警备部	警察署
监狱	牢狱	牢	监	狱	监牢	大牢	囚牢	班房	牢房	看守所	囹圄	铁窗	铁栏杆	地牢	囚室	水牢	禁闭室	囚笼	拘留所
工厂	厂子	厂
矿	工矿
工场	作坊	作	坊	房	小器作
磨坊	碾坊	磨房
酱园	酱坊
商店	铺子	店铺	铺户	店家	商行	商号	店	铺	号	庄	局	肆	柜	公司	洋行	代销店	店堂	供销社	小卖部	信用社	商社	商厦	铺面	营业所	合作社	商家	企业
总店	总行	总公司	母公司	总局
分店	分行	分号	支店	分公司	子公司	支行	孙公司
摊	摊子	地摊	货柜	货摊	摊点	摊位	炕柜	路摊	门市部	小摊	摊儿	摊档
中药店	药铺	药材店	草药店	药店
西药店	药房
书店	书局	书铺	书摊	书报摊
理发店	理发馆	理发厅	美发厅	发廊	美容美发店	美发店	理发室	美容院
饭店	饭馆	饭铺	饭庄	菜馆	馆子	酒家	酒馆	食堂	餐馆	饮食店	餐饮店
酒店	酒家	酒吧间	酒楼	酒馆	大酒店	酒吧	国宾馆	小吃摊
小吃店	小吃部
旅馆	店	旅社	客店	客栈	旅舍	招待所	下处	公寓	宾馆	行栈	旅店
茶馆	茶楼	茶社	茶坊	茶室	茶堂
当铺	当	典当	押当
裁缝店	成衣铺	服装店	时装店
布店	布庄
杂货店	杂货铺	百货店	百货公司	百货商店	商城	超市
浴室	浴池	澡堂	澡塘	浴场
银行	钱庄	银号	储蓄所	存储点
代办点	代理点
照相馆	摄影部
杂食店	食杂店	便民店
快餐馆	快餐店
咖啡馆	咖啡厅	咖啡吧	咖啡店
工商行	工行
营业厅	营业室
中国人民银行	中国银行	中行
世界银行	世行
中央银行	央行
集团公司	集团
非国有企业	私企
实体	实业
学校	校	学	学堂	黉	该校	母校	全校	学府	院所	院校
私塾	学塾	家塾	馆	村学	社学	书院	村塾
义学	义塾
高等学校	大学	高校
学院	院
专科学校	专科
附属中学	附中
高级中学	高中	普高
初级中学	初中
附属小学	附小
高级小学	高小
初级小学	初小
完全小学	完小	小学	小学校
幼儿园	幼稚园	托儿所	幼儿所
师范学校	师范	师大	师范大学
大专学校	大专院校
职高	职业高中
医科院	医学院
大职校	职校	职大
医院	卫生院	病院	诊所	诊疗所	医务室	保健室	保健站	卫生所	卫生站	医务所
产院	妇产科
精神病院	疯人院
救护所	庇护所
疗养院	休养院	休养所	干休所	康复站
敬老院	养老院	福利院	老人院	托老院
电影院	影院	影戏院	影剧院	电影室
剧院	剧场	戏院	戏园子	歌剧院	戏馆子	小剧场
剧团	剧院	班子	班	草台班	戏班	戏班子	马戏团
文工团	歌舞团	文联	评剧团	豫剧团
体育场	运动场	操场
舞场	舞厅
文化宫	文化馆	俱乐部	游乐场	游艺场	文学社	画报社
博物馆	博物院
报社	报馆
电台	无线电台	转播台
联社	联合社
速度	速	快	快慢	进度
声速	音速
音强	音势
地震烈度	烈度
抗张强度	抗拉强度
精密度	精度
高度	高	高矮	高低	长短	长
海拔	高程
深度	深	吃水	深浅	纵深	进深
厚度	厚薄	薄厚
宽度	宽窄	幅度	幅面	开间	肥瘦	宽	幅	大幅度	调幅	幅宽	增幅	涨幅	升幅	步幅	播幅	增长率	步长	宽幅	净宽	单幅	小幅
个头	个儿	身材	身长	身量	个子	块头
长度	长	尺寸	长短
尺码	尺寸
缩尺	比例尺
浓度	浓淡	深浅
重量	分量	重	轻重	份额	份量	毛重	千粒重	净重
负荷	负载	载荷	载重	荷重
音量	响度	高低	轻重
光度	灯光	光
工资分	工分
频道	频段	频率段
声望度	知名度
温度	温	热度
地温	土温
烧	热	热度	光热
燃点	着火点	发火点
距离	间隔	间距	跨距	区间
路程	行程	里程	路途	路	程	总长
规程	回程	归程
波幅	振幅
数量	数	数目	数码	数额	额数	多少	多寡	数据
总数	总额	总和
余数	仂
人数	人头	人口	人	口	丁	家口	食指	总人口
字数	篇幅
整数	平头	成数
尾数	尾子	零数	奇
答数	得数
和数	和
差数	差
乘积	积
乘方	乘幂	积数
偶数	双数
奇数	单数
分数	分
零数	零头	零儿
函数	因变量
逆函数	反函数
因数	因子
等差级数	算术级数
等比级数	几何级数
自变数	自变量
十进对数	常用对数
无穷大	无限大
无穷小	无限小
方根	根
常量	恒量
当量	化学当量	热功当量
食量	饭量	胃口
空额	缺额	缺
一	壹	么	幺	单科	单件	单个
二	贰	两	俩	二元
三	叁	仨
四	肆
五	伍
六	陆
七	柒	拐
八	捌
九	玖
十	什	拾
廿	念
百	佰
千	仟
亿	垓
零	洞	零蛋
第一	头	元	首	初	伯	长	冠	魁	正	处女	首先	最先	老大	状元	首次	初次	首届	首批	首任	首位	头版	排头	正负	首度	头条	首家
第二	二	次	仲	亚	其次	老二	伯仲	次之
第三	三	叔	老三	其三
第四	四	季
半	一半	半拉	半拉子	半截	半数	参半	拦腰
过半	大半	多半	多数	大多数	左半	半数以上
小半	少数	一点	一些	好几	或多或少	某些	几许	几分
概数	约数
几	数	若干	些	把	两	头	来
内外	上下	左右	光景	前后
多	出头	冒尖	挂零	有零	开外	有余	余	强	又	多种
不到	近	奔	上	弱
若干	多少	好多	几多	几何	几	多	多多少少
倍数	倍	倍儿	翻番	公倍数
成数	成
折扣	折头	折	扣	对折	倒扣
比率	率	比值
概率	几率	或然率	票房价值
比例	比	对比
正比例	正比
反比例	反比
比重	比例	百分比	百分数	分之
数量单位	标准单位
群	帮	帮子	班	伙	批	股	起	起子	队	拔	把子
排	进	溜	列	行	趟
串	挂	嘟噜	梭子	缗
堆	团	墩
叠	沓	摞
丛	束	簇	炷	蔸	蓬
掐	把	把子
绺	缕
捆	荮	卷	各卷
抱	捧	围
绞	股
担	挑
身	套	一整套
袭	领	件
对	双	副
种	样	类	种种
各	个	员	位	号	各队	各类	各条	各项
个	只	每支
栋	座	所	幢
层	级	磴
棵	蔸	株
架	台	部	台数
辆	部	这部
家	户
丘	片	块	畈
张	纸
匹	头	腔	峰	条
尾	条
颗	粒	发	丸
幅	帧	轴
艘	只	条
枝	条	杆	挺	根	管	茎
册	本
帙	部	套	函
首	篇
餐	顿
股	剂	帖	煎	味	料
桌	席
扇	樘	槽
摊	汪
道	条	泓	股	湾	抹
件	码	起	宗	桩	项	档子	档儿
批	票	宗
回合	合
回	章	节	段	章节	条块	区块	回目
截	段	段落	段子
派	片	番
线	丝
班	趟	次	件次
客	份	卖
枚	朵
千伏安	千瓦
车皮	专列
次	度	回	道	番	趟	遍	巡	和	水	历届
周	圈	匝	遭	转	来回
阵	阵子	一阵	阵阵
下	记	把	一下
中纬度	经纬度
公尺	米
盎司	英两
长	漫长	修长	漫漫	修	永	条	久	长达	长长的	长条
细长	狭长	超长
短	短小	短巴巴	短出出	短粗	短撅撅	短短的
高	万丈	摩天	参天	凌云	亭亭	危	峨	高耸入云	干云蔽日	最高	高高的	嵩	齐天
修长	颀长	瘦长	细高挑儿	细高	高挑	大个
高耸	突兀	屹立	屹然	兀
高大	魁梧	魁伟	伟岸	巍然	岿然	巍峨	巍巍	崔嵬	傻高	嵬	巍	峻
矮	锉	低	低平	低于	矬	压低	最低	倭
矮小	短小	小个儿
矮胖	矮墩墩	五短身材
大	巨	宏	巨大	硕大	庞大	宏大	偌大	粗大	高大	硕大无朋	洪大	极大	庞然大物	特大	大幅度	翻天覆地	鞠	硕	庞
宽大	肥大	肥
大型	巨型	重型	特大型
大而无当	重特大	超大	硕大无比
中	中等	半大	中型	适中	不大不小	中小
小	微	细	纤	微小	细小	微细	细微	幽微	纤维	纤毫	纤小	短小	矮小	蝇头	一丁点儿	小不点儿	微乎其微	不大	最小	芾	小小	很小	小小的
小型	微型	袖珍
广阔	宽阔	开阔	辽阔	广大	广漠	广	旷	空旷	空阔	空廓	寥寥	苍茫	荒漠	浩荡	浩瀚	浩渺	弥漫	茫茫	莽莽	漠漠	恢恢	连天	洪洞	万顷	无边	无涯	无垠	无际	无边无际	漫无边际	一望无际	漫无止境	深广	天网恢恢	硝烟弥漫	灏	漫无际涯	无量	一展无垠	浩瀚无垠	空阔无垠	浩然	瀚	浑然无垠	广袤无际	一望无垠	宏阔	淼	一望无涯	苍莽	广阔无垠	旷远	浩淼	寥廓	氤氲
滔滔	咪咪	洋洋	泱泱	波涛万顷	烟波浩渺	烟波浩淼
宽敞	宽阔	宽大	宽广	宽绰	宽舒	宽余	宽	敞	轩敞	坦荡	开豁	开阔	开朗	放宽	宽旷	宽心	拓宽	宽宽敞敞	平阔	坦坦荡荡	阔大
狭窄	窄	狭	小	陋	瘦	狭小	窄小	褊狭	局促	狭隘	逼仄	湫隘	仄	小心眼儿	隘	偏狭	褊	窄窄	蹙
深	幽	幽深	深邃	窈窕	万丈	深不可测	深深	深深地	水深	深深的
浅	浅水
厚	厚实	丰厚	厚墩墩	厚厚	厚实实	粗厚	厚厚的
薄	单薄	超薄	薄薄的
扁	扁平
粗	粗大	肥大	粗壮	粗实	粗重	侉	奘	阔	五大三粗	粗墩墩	短粗
细	纤细	细小	纤小	细长	苗条	细弱	巨细	细部	细高	细条条	细细	细细的
胖	肥	肥胖	肥壮	肥硕	肥实	肥乎乎	心广体胖	胖墩墩	胖乎乎	心宽体胖	肥得鲁儿	肥滚滚	肥囊囊	膀阔腰圆	肥厚	腴	胖胖	膘肥肉厚
丰满	丰盈	丰腴	充盈	丰润
臃肿	虚胖
大腹便便	脑满肠肥
瘦	清瘦	消瘦	清癯	瘦小	瘦瘠	干瘪	枯瘦	骨瘦如柴	骨头架子	瘦干	瘦骨嶙峋	瘦削	干瘦	黑瘦	黄皮寡瘦	精瘦
憔悴	枯槁	面黄肌瘦	鸠形鹄面
直	笔直	挺直	垂直	铅直	直溜	直溜溜	僵直	直挺挺	直统统
曲	曲折	弯	弯曲	弯弯曲曲	曲曲弯弯	弯矩	弯曲形变	鞠
委曲	迂曲	盘曲	蜿蜒	羊肠	逶迤	屹立	转弯抹角	曲里拐弯	峰回路转
拳曲	蜷曲
九折	九曲回肠
平	平行
挺	笔挺	挺括	挺起
皱	纵	揪	翘	翘棱	皱皱巴巴	皱巴巴
正	端正	周正	平正	方正	方方正正	平头正脸	板正	端端正正
歪	歪斜	倾斜	偏斜	趄	坡	歪歪扭扭	歪七扭八	七扭八歪	七歪八扭	横倒竖歪	歪歪斜斜	东倒西歪
规则	平整	平展展	条条框框
参差	参差不齐	横七竖八
嶙峋	嶙峋	奇形怪状
尖	尖锐	尖溜溜
秃	钝
凸	穹隆	阳	拱	鼓鼓囊囊	鼓囊囊	努	凸出	凸显
石拱	拱券
凹	凹陷	下陷	洼陷	低洼	湫隘	眍	阴	塌	瘪	洼	低凹	圬
平坦	平缓	坦缓	坦	平	平滑	平正	平整	平展	平易	坦荡	一马平川	平平整整	坦坦荡荡
崎岖	起伏	此起彼伏	此伏彼起	起伏跌宕	起起伏伏的	起起伏伏	跌宕起伏	涨跌
凹凸不平	高低不平	坑坑洼洼	疙疙瘩瘩	七高八低	七上八下	崎岖	崎岖不平	坎坷不平	凹凸
陡峭	陡	陡直	峭拔	壁立	峭	陡陡仄仄
高峻	陡峻	峻峭	连天	峥嵘	嵯峨	巍峨	峻	嵘	峥	峭拔冷峻
方	正方	见方	四方	方方正正	方块	方框	五方
长方	矩形	矩
圆	浑圆	滚圆	滚瓜溜圆	团团	团	圆溜溜	圆滚滚	圆乎乎	溜圆	圆周	圆圆	圆圆的	圆浑
椭圆	长圆	扁圆	扁圆形
半圆形	弧形	拱形	拱	半圆	圆弧
半月形	弯月形	月牙形
多	许多	好多	这么些	广大	浩大	浩繁	无数	众多	众	群	丛	博	累累	洋洋	洒洒	重重	那么些	有的是	成千上万	胸中无数	好些	很多	居多	衮衮	奂	莘	夥	诸多	广土众民	过多	过剩	森	不少	良多	多多	成百上千	上百	为数不少	不在少数	过江之鲫	盈怀充栋	游人如织	大队人马	多多益善
大量	大批	一大批	大宗	巨额	巨	巨大	千万	万万	亿万	千千万万	成千成万	成千累万	成批	许许多多	数以百计	不可估量	数以百万计	数以十万计	数以亿计	用之不竭
如林	如云	成堆	连篇	不乏	满眼	满目	林立	满腹	林林总总	大有文章
济济	芸芸	莘莘	大有人在	不乏其人	藏龙卧虎	人才辈出	人才济济
一连串	一系列	无穷无尽	浩如烟海	不可胜数	不计其数	不一而足	不胜枚举	数不胜数	数以万计	不知凡几	比比皆是	目不暇接	恒河沙数	更仆难数	车载斗量	汗牛充栋	多如牛毛	洋洋洒洒	密密麻麻	鳞次栉比	星罗棋布	满山遍野	遮天盖地	铺天盖地	满坑满谷	雨后春笋	泛滥成灾	举不胜举	漫山遍野	弥天盖地	密麻麻	名目繁多	千家万户	系列	为数众多	苇丛	文山会海	聚讼纷纭	羽毛丰满	多重	多级	层层	多样	多元
擢发难数	罄竹难书
少	少数	个别	零星	点滴	稀	寡	鲜	半	两	片	无几	有数	有限	一二	区区	半点	一丝	星星	少许	些微	些许	蝇头	单薄	简单	寥落	一点儿	这么点儿	那么点儿	一丁点儿	三三两两	星星点点	一把子	一定量	一星半点	点儿	丁点儿	少于	甚微
寥寥可数	寥寥无几	寥若晨星	屈指可数	硕果仅存	微乎其微	微不足道	九牛一毛	凤毛麟角	聊胜于无	所剩无几	绝少
少量	小量	涓埃	微量	为数不多
丝毫	秋毫	分毫	毫厘	毫发	锱铢	一丝一毫	亳
繁多	万端	万千	什锦	繁	多种多样	各式各样	形形色色	五花八门	千头万绪	五光十色	森罗万象	丰富多彩	应有尽有	层出不穷	层见叠出	纷	丰富多采	各样	各种各样	莫可指数	繁博	丑态百出	饶有	缛
纷繁	繁杂	纷纭	纷纷	纭纭	纷纷扬扬	缤纷
稀少	希少	希罕	希有	鲜有	少有	希世	罕见	少见	鲜见	偶发	难得	铁树开花	千载难逢	千载一时	百年不遇	十年九不遇	不可多得	稀罕	稀缺	稀世	罕	荒无人烟	难得一见	阔阔的	稀有	万分之一	千分之一	斑斑	薄薄	层层
单	只	孤	独	寡	个	单瓣
双	偶	对	夹	复	俪	骈	对偶	双料	双双	对仗
全部	全体	一切	所有	整个	整整	全副	全份	成套	整套	一体	囫囵	全	整	合	阖	举	通	普	尽	悉	一	满	浑	周	遍	漫	上上下下	里里外外	百分之百	不折不扣	原原本本	一五一十	布满	从头至尾	总体	任何	万事	凡事	竭	满贯	漫天	全勤	通栏	全方位	全套	全总	满门	俱全	方方面面	尽数	全路
部分	有些	有的	有	局部	片	片段	一部分	一对	一些	组成部分	有点儿
少数	个别
多数	大部分	大多数	绝大多数	大部
密	稠	稠密	浓密	致密	细密	繁密	密实	密匝匝	密密匝匝	密密层层	层层叠叠	密密丛丛	黑压压	森	密密	密布
疏	稀	稀疏	萧疏	疏落	疏散	稀稀拉拉	稀稀落落
冲散	打散
茂盛	旺盛	丰茂	盛	茂	丰	红火	繁茂	蕃茂	莽莽	萋萋	菁菁	蓊郁	繁芜	繁荣	茸茸	郁郁	蓬	夭	茸	枝繁叶茂	奂	芾	葳	花繁叶茂	毛茸茸	绿绿葱葱	蓊蓊郁郁
葱翠	葱茏	葱郁	茏葱	苍郁	葱葱	郁郁葱葱	郁郁苍苍	茵茵
茂密	森然	森森	扶疏	莲蓬
荒芜	荒废	荒	废	草荒	寸草不生	杳无人烟	人烟稀少	芜	撂荒
肥沃	肥美	肥	沃	膏腴
贫瘠	瘠薄	薄	瘦	瘠	瘦瘠	薄地	贫壤瘠土	硗薄
空	空	空落落	空荡荡	光溜溜	空无所有	一无所有	别无长物	空空如也	空空洞洞	家徒四壁	空白	空串	空手	空域	一无所获
空心	秕	中空
实	实心
满	满登登	满满当当	满当当	满满
饱满	饱	饱和
满座	客满	座无虚席	满额	满员	爆满	高朋满座
满街	满城风雨
光秃秃	秃	童	濯濯
完整	完全	完好	整体	整	完	圆	浑然一体	完好无缺	完好无恙	完好无损	整机	总体	共同体	完完全全	整整的	一体化
齐全	齐备	完备	全	齐	实足	丝毫不少	兼备	大全	全称	详备	万事俱备
残缺	欠缺	残	残缺不全	半半拉拉	有头无尾	减头去尾	掐头去尾	斩头去尾	挂一漏万	残编断简	残部	不尽
残破	秃	支离	支离破碎
残存	残留	残余
零碎	细碎	零星	零落	零散	碎	散	零	零七八碎	七零八碎	七零八落	一鳞半爪	东鳞西爪	鸡零狗碎	零打碎敲	零零星星	零敲碎打	碎片	心碎	散装
破烂	破碎	破损	破败	破绽	褴褛	麻花	烂	破	败	敝	百孔千疮	千疮百孔	破烂儿	破破烂烂	破相	烂乎乎	破烂不堪
鹑衣百结	捉襟见肘	衣不蔽体	褴褛不堪
冗长	长	长篇大论	洋洋洒洒	没完没了	连篇累牍	累牍连篇	拖泥带水	洋洋万言
简短	短小	简练	精练	凝练	洗练	简洁	简要	简明	简单	精简	简	简明扼要	要言不烦	言简意赅	从简	简洁明了	精短
紧	严	紧密	紧身	严紧	严密	严实	紧巴巴	紧绷绷	紧紧	收紧	严严实实	紧巴
松	泡	糠	暄	蓬	松软	松弛	松散	稀松	平松	蓬松	尨茸	弛懈	宽松
硬	坚	棒	僵	坚硬	硬棒	硬实	强直	僵硬	硬邦邦	梆硬	绷硬	冻僵	干梆梆	硬梆梆	硬邦邦的
板	板结	板实
软	柔	软和	绵软	柔软	柔韧	柔嫩	松软	软绵绵	软乎乎	软塌塌	细软	心软	软软	柔曼	绒绒的	软性
烂	酥	烂糊	稀烂	面糊	面乎乎
脆	松脆	酥脆	脆生
牢	固	牢靠	牢固	坚固	强固	结实	扎实	皮实	坚实	确实	瓷实	耐久	耐用	经久耐用	金汤	牢牢	户枢不蠹	耐穿	凝固	死死	天罗地网	死死地	流水不腐	凝炼
韧	坚韧	柔韧	韧性	艮	韧劲
浓	厚	浓重	浓厚	浓浓的	浓浓
稠	糨	稠乎乎	粘稠
黏	黏糊	腻	糯	油腻腻
稀	薄	谈	稀薄	淡薄	稀溜溜	淡淡的
重	沉	沉重	沉沉	沉甸甸	压秤	厚重	辎重
轻	轻飘	轻飘飘	泰山鸿毛	轻车简从	轻轻	轻于鸿毛	轻装	轻轻地	轻轻的	轻度
笨重	粗重	粗笨
轻巧	精巧	灵巧
轻快	轻飘	轻盈	轻巧	轻柔	翩然	翩翩	翩跹
锋利	利	快	锐	锐利	尖利	飞快	尖锐	削铁如泥
钝	不快
生	生涩	夹生	青	半生不熟	青青
熟	熟透	黄	黄熟	烂熟
嫩	鲜嫩	细嫩	柔嫩	鲜嫩嫩	香嫩	白嫩
响	高	响亮	豁亮	洪亮	嘹亮	琅琅	朗朗	高亢	高昂	响当当	铿锵	铿然	激越	声如洪钟	龙吟虎啸	轰响	宏亮	亢	朗	脆亮	脆响	怒号	鸣笛
雷鸣	雷动	震耳欲聋	响彻云霄	响遏行云	穿云裂石	瓦釜雷鸣	振聋发聩	如雷似火
轻	细	低	轻柔	低微	细微	细小	悄悄	幽咽	细声细气	不绝如缕	轻轻的	悄悄的	细语
尖	尖利	尖锐	尖溜溜
粗	粗重	粗大	粗壮	瓮声瓮气
沙哑	嘶哑	沙
低沉	深沉	闷
悦耳	入耳	顺耳	好听	动听	受听	中听	悠扬	悠悠扬扬	磬	天花乱坠
婉转	缠绵	柔和	圆润	抑扬顿挫	娓娓动听	余音绕梁	珠圆玉润	大珠小珠落玉盘	声如银铃	宛转	悠扬	抑扬	悠悠扬扬
清脆	脆	脆生	清朗
难听	刺耳	扎耳朵	不堪入耳
亮	明	皓	明亮	亮堂	通亮	光亮	雪亮	鲜亮	敞亮	豁亮	透亮	清亮	明朗	清明	通明	鲜明	光明	透亮	辉煌	明快	金灿灿	亮光光	亮闪闪	亮铮铮	亮堂堂	火光烛天	光芒万丈	光灿灿	光辉灿烂	心明眼亮	黑亮	烁	熠	亮晃晃	亮亮的	煌	晔	灿	炳	焕	炯	杲	银亮	煊	锃亮	灼亮	红灿灿	灯火辉煌	空明	有光
耀眼	夺目	炫目	刺眼	灿烂	粲然	明晃晃	灿若云霞	灿若群星	璀璨	群星璀璨	璀璨夺目	耀目	光彩耀目
炯炯	灼灼	灼	炯炯有神	熠熠生辉	熠熠
皎洁	皎皎	皓月当空	月明如镜	月光如水	朗	秋月当空
光洁	晶莹	晶亮	明澈	亮晶晶	水汪汪	亮泽	光彩照人
油光	油汪汪	贼亮
荧荧	熹微	蒙蒙亮	麻麻亮	微亮
暗	阴暗	幽暗	晦暗	昏暗	灰暗	黯淡	暗淡	阴沉	昏沉	昏黄	黯然	惨淡	惨白	灰蒙蒙	黑糊糊	黑黝黝	天昏地暗	昏天黑地	麻麻黑	森	阴森森	毒花花	灰沉沉
背阴	背光
幽幽	幽然
黑暗	昏黑	黝黑	黢黑	墨黑	漆黑	黑	黑洞洞	黑沉沉	黑咕隆咚	黑灯瞎火	漆黑一团	暗沉沉	黑咕隆冬	昧
清澈	清亮	清明	明净	明澈	澄澈	澄清	纯净	清澈	澄清	清	洌	清凌凌	澄	潇	清洌	滢	清洌洌	河晏水清	清冽
透明	透亮	晶莹	晶莹剔透	透剔
浑浊	混浊	浑	浊
清晰	明晰	清	清楚	历历	分明	鲜明	一清二楚	黑白分明	旁观者清	清清楚楚	明明白白	冥	澄	丁是丁	白纸黑字	清丽	不可磨灭
模糊	糊涂	朦胧	莽苍	迷茫	渺茫	缥缈	隐约	隐隐	微茫	恍惚	依稀	白蒙蒙	黑糊糊	黑忽忽	黑乎乎	模糊不清	糊里糊涂	若明若暗	影影绰绰	隐隐约约	隐约可见	雾里看花	模模糊糊	飘渺	胡里胡涂	恍恍忽忽	若隐若现	莫明其妙	不明	盲目	蒙胧	渺无音信	幽渺	恍	迷蒙	朦朦	盲用	惺忪
远	遥	遥远	遥遥	辽远	悠远	迢迢	幽幽	杳渺	千里迢迢	千山万水	万水千山	天南海北	远在天边	天各一方	天涯海角	十万八千里	远远	邈	幽远	邈远	邃远	不远千里	迢迢万里	老远	遐
偏远	边远
远程	远道	长途	远距离	长距离	中长途
近	在望	近便	咫尺	近在咫尺	近在眼前	近在眉睫	朝发夕至	一山之隔	一水之隔	一衣带水	一墙之隔
邻近	邻	附近	地邻	紧邻	邻县	邻座	相邻	隔壁	比肩而邻	四邻八村
短途	短距离	近距离
以近	远近
早	早日	早早儿	早早	为时过早	为时尚早	先于	先入为主
初	新
迟	晚	深	晏	日上三竿	姗姗来迟	迟到	为时过晚
暮	残
夜深	夜深人静	三更半夜	半夜三更
快	速	疾	飞	快速	高速	迅速	神速	迅猛	火速	飞速	全速	迅捷	敏捷	矫捷	便捷	轻捷	迅疾	麻利	快当	飞快	飞跃	长足	灵通	劈手	飞针走线	急若流星	很快	迅	不会儿	快快	霎时	短平快	高效	快捷
如梭	跌进	速成	高效率
疾驰	一溜烟	腾云驾雾	骨腾肉飞	风驰电掣	追风逐电	一日千里	日行千里
光阴似箭	日月如梭
不胫而走	不翼而飞
急转直下	一泻千里	迅雷不及掩耳	稍纵即逝	眼捷手快	兵贵神速	迅雷不及掩耳之势
不假思索	一目十行	一挥而就	一蹴而就
指日可待	计日程功
迅疾	急速	急性	急遽	急剧	急骤	急促	湍急	急	急湍	急湍湍	加急	疾速	节节
慢	缓	徐	款	缓慢	舒缓	款款	徐徐	迟迟	磨蹭	迂缓	迟缓	迟延	迟滞	悠悠	冉冉	慢性	慢慢腾腾	慢悠悠	慢条斯理	蜗行牛步	缓缓	减缓	慢慢吞吞	慢慢悠悠	慢腾腾	慢吞吞	暂缓	放缓	磨磨蹭蹭
频率	效率
长久	久长	悠久	许久	好久	良久	久长	绵长	绵绵	漫长	漫漫	久远	长远	遥远	悠远	悠长	长期	老	永	马拉松	久而久之	长此以往	旷日持久	遥遥无期	天荒地老	地老天荒	天长日久	日久天长	天长地久	地久天长	时久天长	久	久久	经久	经久不衰	多时	由来已久	一劳永逸	代远年湮	千古不灭	青山常在	历演不衰	历久不衰	年代久远
多年	有年	积年	连年	成年累月	经年累月	积年累月	长年累月	穷年累月	累月经年	年久月深	年深月久	整年累月	常年累月	从小到大
整年	通年	终年	常年	成年	长年	一年到头	终岁
整天	终天	终日	成天	成日	一天到晚	从早到晚	无日无夜	整天价	全日
整夜	通夜	终夜	彻夜	通宵	通宵达旦
日日夜夜	日以继夜	没日没夜
半晌	半天	有会子	有日子	常设
永远	永世	永恒	永久	恒久	千古	万古	万年	万世	万代	世代	永	千秋万代	子孙万代	世世代代	祖祖辈辈	子子孙孙	万古千秋	亿万斯年	永生永世	终古不息	不可磨灭
短促	短暂	急促	局促	在望	短	浅	为期不远	指日可待	五日京兆	一朝一夕	墨迹未干	尸骨未寒	曾几何时	兔子尾巴长不了	不久	短短	短命	短跑	即期	一朝	好景不长
一会儿	会儿	一忽儿	一阵子	不一会	片刻	一刻	顷刻	漏刻	说话	片时	少时	少刻	少顷	俄顷	顷	须臾	巡	一时半刻	稍顷	时隔不久
一眨眼	一转眼	一晃	一刹那	刹那间	霎时间	一霎	一瞬	转瞬间	瞬间	倏地	倏忽	倏	瞬	瞬息间	转眼间	转手	转脸	一下子	俯仰之间	弹指之间	转	分秒	瞬间	瞬息	一念之差	一时间	刹那	一霎时	一下	忽而	时而	刹时	转瞬	转眼	霎时	瞬即	瞬时	顷刻间	下子	一瞬间	一晃儿
暂时	临时	权时	暂	少	小	暂行	短时	暂时性	临时性
冷	寒冷	冰冷	冰凉	冻	寒	冷冰冰	阴冷	僵冷
清寒	冷飕飕	冷丝丝	冷若冰霜	冷溲溲
苦寒	严寒	高寒	冷峭	寒峭	刺骨	惨烈	干冷	凄清	寒气袭人	天寒地冻	滴水成冰	冰天雪地	冰冻三尺	凛凛	凛冽	春寒	料峭	春寒料峭	奇寒	寒风料峭	寒意料峭
寒湿	发潮
饥寒	饥寒交加
热	热火	热和	热乎	热乎乎	热烘烘	热腾腾	热滚滚	热哄哄	热力	热呼呼
烫	滚烫	滚热	灼热
炎热	炎炎	暑热	炽热	火热	酷热	酷暑	燥热	熏蒸	炎	署	火辣辣	热辣辣	骄阳似火	汗流浃背	汗如雨下	铄石流金	流金铄石	暑	烈日当空	溽暑	燠	炽
凉	凉快	风凉	阴凉	荫凉	凉丝丝	凉飕飕	沁人心脾	凉苏苏	凉溲溲	清凉	秋凉	凉意
暖	温	暖和	和暖	和煦	温煦	晴和	和畅	融融	温暖	温和	温暾	暖烘烘	暖洋洋	风和日暖	风和日丽	采暖	暖融融	煦	暖乎乎	温软	温暖如春
冷热	寒热
凉爽	爽	爽朗	沁人心脾	滑爽	沁入心扉
闷气	闷热	闷	郁热	不透气
干燥	干	燥	干涩
干枯	焦枯	枯槁	干巴	干巴巴
干涸	干旱	旱	枯竭
潮湿	濡湿	湿润	回潮	潮乎乎	潮	潮呼呼	汗浸浸	温湿	湿寒	潮润	溽热
湿	湿淋淋	溻	湿透	润湿	湿乎乎	阴湿	湿漉漉
滋润	润泽
新	簇新	崭新	全新	别树一帜	独创性
新式	新颖	新型	时新	摩登	时髦	行时	入时	时兴	流行	风行	风靡	时	行	新星	最新	面貌一新	流行性
时鲜	应时	应景
新鲜	鲜	清新	清馨	鲜味	生鲜
旧	陈旧	陈	老	老掉牙	老牛破车	破旧	年久失修
老式	过时	不兴	背时	老一套	不合时宜
古老	古	古旧	老古董	苍古
古朴	古拙	古雅	古色古香
美丽	漂亮	好看	受看	中看	入眼	顺眼	悦目	美观	华美	优美	美妙	美	丽	菲菲	美美	幽美	泛美	姣好
秀美	秀气	清秀	灵秀	挺秀	娟秀	韶秀	秀丽	明丽	俏丽	俏	奇秀	脆丽	娟	绮	秀色	虬曲挺秀	钟灵毓秀	水灵灵
华丽	富丽	壮丽	绮丽	瑰丽	艳丽	花枝招展	亮丽	壮伟
鲜艳	浓艳	妖艳	明媚	秀媚	妩媚	妍	艳	美艳
妖艳	妖冶	妖媚	妖娆
娇	娇媚	柔媚	娇娆	娇艳	娇滴滴	千娇百媚	柔情绰态	娇艳欲滴
绚丽	绚烂	烂漫	灿烂	如花似锦	光彩夺目	鲜艳夺目	万紫千红	姹紫嫣红	花团锦簇	琳琅满目	美不胜收	多姿多彩	绚	繁花似锦	分外夺目	光灿夺目	灿烂夺目	绚丽夺目	灿若云霞	灿若星河	光芒四射	灿	多姿
锦绣	入画	旖旎	山明水秀	风景如画	花香鸟语	山青水秀	华章锦绣
美貌	标致	体面	上相	柔美	冶容	秀雅	曼妙	绰约	婵娟	娟娟	窈窕	绝色	眉清目秀	堂堂正正	一表人才	明眸皓齿	冰肌玉骨	花容玉貌	秀外慧中	闭月羞花	沉鱼落雁	国色天香	天香国色	天姿国色	倾国倾城	佳妙无双	倾城倾国	绝世无匹	姣妍	西装革履	阳刚之美	楚楚静立	眉清目朗	楚楚动人	风华绝代	美若天仙	如花似玉	嫣然	婷	婷婷
俊美	俊秀	俊	俏	俊俏	俏皮	英俊	堂堂
翩翩	袅娜	婀娜	娉婷	亭亭	袅袅婷婷	仪态万方	亭亭玉立	绰约多姿
丑陋	难看	寒碜	猥琐	丑	陋	其貌不扬	面目可憎	龇牙咧嘴	贼眉鼠眼	獐头鼠目	见不得人	猥	人老珠黄
雅致	雅观	文雅	清雅	淡雅	古雅	雅	大雅	幽雅	优雅	典雅无华
洋气	洋	文明	洋里洋气
土气	土	土里土气
豪华	华	华丽	华贵	堂皇	富丽	富丽堂皇	画栋雕梁	雕栏玉砌	美轮美奂	冠冕堂皇	金碧辉煌	蓬荜增辉	堂堂皇皇	珠光宝气	雍容华贵
奢华	浮华	阔气	阔绰	阔
铺张	排场	铺排	讲排场
朴素	纯朴	简朴	质朴	朴质	艰苦朴素	朴	朴实无华	质朴无华	无华	醇朴	拙朴	清纯
璞玉浑金	浑金璞玉	归真返璞
简陋	陋	鄙陋	因陋就简	破瓦寒窑	低质
光滑	光	滑	光溜	光溜溜	滑溜	滑腻	光润	光洁	滑润	溜光	细腻	细润	光乎乎	溜滑	油亮
毛糙	粗糙	毛	糙	麻	毛乎乎
精巧	细巧	工巧	纤巧	小巧	奇巧	精致	工致	精细	工细	细密	精密	精美	精妙	秀气	玲珑	细	精	小巧玲珑	玲珑剔透	巧夺天工	鬼斧神工	神工鬼斧	娇小	娇小玲珑	精雕细镂	精制	水磨工夫	迷你	精工细作
讲究	考究
粗糙	毛糙	粗陋	粗劣	粗疏	粗	糙	粗笨
人造	人工	人为	事在人为
自动	机动	电动	机关	半自动	从动	活动	自行	全自动	键钮	自发性
雄	公	牧	叫	儿	骚	牡
男	男性	乾	阳
雌	母	牝	草
女	女性	坤	阴
年老	老	上岁数	上年纪	高大	苍老	衰老	年高	年迈	老迈	高迈	白头	皓首	大年	老大	老朽	朽迈	老态龙钟	年事已高	鹤发鸡皮	鸡皮鹤发	行将就木	大龄	七老八十	早衰	老弱病残	年迈体弱	老态	古稀之年	年逾古稀
垂暮	垂垂老矣	廉颇老矣
长寿	高寿	长年	寿比南山	万寿无疆	长命百岁	长生不老	龟鹤遐龄	龟鹤延年	益寿延年	延年	万古常青
年轻	后生	青春	少壮	正当年	血气方刚	年轻气盛	年青	青春年少	身强力壮	风华正茂	老大不小	常青	年少	少年心
幼小	幼稚	幼	稚	弱	雏	子	仔	乳	嫩	口轻	粉嫩	幼雏	幼驹	鸡雏	低幼	毛头
健康	康健	强健	健全	健旺	健壮	壮健	结实	强壮	精壮	壮实	硬实	敦实	茁壮	茁实	皮实	硬朗	矫健	健	状	身强体壮	虎背熊腰	虎头虎脑	铜筋铁骨	年富力强	膀大腰圆	膘肥体壮	年轻力壮	身强力壮	康泰	健朗	健硕	身心健康	佶
鹤发童颜	老当益壮	不减当年	童颜鹤发	宝刀不老
孱弱	衰弱	瘦弱	单弱	文弱	虚弱	纤弱	软弱	柔弱	单薄	娇嫩	弱小	孱	弱	虚	弱不禁风	气虚	弱者	娇嫩嫩	娇柔	矫	体弱	年迈体弱	神经衰弱
无力	绵软	酥软	瘫软	软绵绵	手无缚鸡之力	软弱无力
病恹恹	恹恹	病病歪歪	面黄肌瘦	心力交瘁	步履维艰	步履艰难	未老先衰	病歪歪	病殃殃	要死不活	体弱多病
红	赤	朱	丹	茜	绯	彤	绛	通红	鲜红	血红	火红	朱红	赤红	猩红	殷红	潮红	嫣红	红润	红彤彤	红通通	红扑扑	红艳艳	红不棱登	红光光
淡红	浅红
粉红	桃红	妃色	粉色	桃色	粉乎乎	粉扑扑	肉色
大红	绯红	品红
深红	暗红
黄	蜡黄	苍黄	昏黄	焦黄	枯黄	黄灿灿	黄澄澄	金煌煌	棕黄	发黄
淡黄	牙色	浅黄	嫩黄	鹅黄
米黄	米色
杏黄	橙黄	橙色
金黄	金色
土黄	藤黄
蓝	蔚蓝	天蓝	碧蓝	宝蓝	蓝盈盈	蓝晶晶	蔚
淡蓝	葱白	月白	品月
深蓝	湛蓝	靛蓝	靛	蓝靛	靛青
藏蓝	品蓝
藏青	海军蓝	海昌蓝	瓦蓝
青	苍	青色	青青	粉代万年青
淡青	蛋青	鸭蛋青	玉色
蟹青	铁青
苍苍	黛色
绿	碧	翠	碧绿	青绿	青翠	青葱	苍翠	翠绿	绿油油	绿茸茸	碧油油	翠绿色	绿茵茵	绿莹莹	铺锦叠翠	滴翠	青翠欲滴	叠翠
嫩绿	淡绿	浅绿	翠绿	葱绿	水绿	湖绿	湖色	苹果绿	淡青色
深绿	墨绿	暗绿	黛绿	墨绿色
紫	绀青	紫色
雪青	青莲色	藕荷	淡紫
赭	红褐色	棕色	酱色	赭色
浅棕	驼色	咖啡色
褐	栗色	茶褐色	茶色	褐色
深褐色	古铜色
白	粉	霜	银	雪	素	缟	皓	皑皑	洁白	雪白	粉白	乳白	白净	皎洁	凝脂	白花花	白晃晃	白茫茫	白不呲咧	白皑皑	白乎乎	白净净	细白	嫩白	颢
苍白	惨白	煞白	刷白	死灰
花白	斑白	灰白	苍苍	白苍苍	白发苍苍
灰	灰溜溜	灰不溜秋	灰色
深灰	暗灰	深灰色
黑	青	乌	皂	墨	缁	黔	墨黑	漆黑	黢黑	乌黑	乌亮	黝黑	焦黑	黧黑	黑油油	黑黝黝	黑黢黢	黑漆漆	黑糊糊	乌油油	乌溜溜	黑不溜秋	浓黑	油黑	黧	发黑	黢	黑滔滔
深	浓	大	暗	老	深深的
淡	嫩	浅
鲜艳	花哨	花里胡梢	花里胡哨	争艳	明艳	发花
五彩	彩色	花	彩	印花	杂色	五颜六色	五色缤纷	花花绿绿	花团锦簇	万紫千红	姹紫嫣红	大红大绿	花红柳绿	多彩	多姿多彩	五彩纷呈	五彩缤纷	绚丽多彩	绚丽多姿	异彩	嫣	万紫千红春满园	斑块	色彩缤纷	异彩纷呈	色彩纷呈	五彩斑斓	多姿
斑斓	光怪陆离	斑	色彩斑斓	耀斑
斑驳	斑驳陆离	花花搭搭
素净	素	淡	素淡	清淡	素雅	淡雅	朴素	素朴	素性	朴素无华
香	喷香	香喷喷	芳香	芬芳	芳菲	菲菲	清香	馨香	异香	香泽	芳泽	馥郁	香气扑鼻	甜香	飘香	香扑扑	香气	香味	香馥馥	馥馥	幽香	果香	余香	醇芳	酒香	花香	香醇	香嫩	浓香	馥	馨
浓郁	郁郁
臭	荤	臭烘烘	臭气熏天	臭乎乎	臭气	臭味	恶臭	五荤
狐臭	狐臊
腥	腥气	土腥气	血腥	腥味儿
膻	腥膻
臊	臊气	腥臊	乳臭
甜	甘	蜜	糖	甘甜	香甜	甜美	甘美	甜丝丝	甜津津	甘之如饴	甜味	甜滋滋	糖蜜	甜甜的
酸	酸溜溜	酸度	发酸
苦	苦口	甘苦	苦味	苦英英
涩	苦涩
辣	辛	辛辣	麻辣	辣丝丝	辣乎乎	辣味
咸	咸津津	口重	死咸	咸乎乎	咸味
淡	薄	淡薄	口轻	清淡	白不呲咧	淡巴巴
可口	美味	入味	是味儿	够味儿	好吃	适口	顺口	爽口	水灵	鲜美	鲜	香	美味可口
难吃	倒胃口
醇厚	浓厚	纯	厚	浓	酽	冲	浓郁	醇	醇香	浓烈
醇和	清醇
油腻	腻	油汪汪	油光光	油乎乎	隽
清淡	寡	清汤寡水
真实	实	真	诚	诚实	忠实	实际	实在	实打实	笃实	真正	真性	真格的	真心实意	诚心诚意	实事求是	真人真事	真格	真真	动真格的	一是一	真实性
十足	十分	地道	道地	赤	货真价实	原汁原味	地地道道	真金不怕火炼
名副其实	有名有实	名不虚传	名下无虚	真名实姓
虚假	虚	假	伪	赝	虚伪	冒牌	仿真	搀假	假冒伪劣
名义	挂名	应名儿
假想	假设	虚设	设	虚设	子虚	子虚乌有	幻
有名无实	名过其实	名不副实	名存实亡	虚有其表	徒有虚名	言过其实	外面儿光	南箕北斗	挂羊头卖狗肉	假门假事	假眉三道	形同虚设	名难副实	其实难副	名不符实
言不由衷	心口不一	言行不一	表里不一	叶公好龙	假大空	好高鹜远
外强中干	羊质虎皮
确实	实	确	确凿	凿凿	无疑	的确	的	确切	真切	逼真	活生生	翔实	可靠	靠得住	有据	耳闻目睹	有目共睹	有凭有据	有案可稽	千真万确	无可置疑	毋庸置疑	不容置疑	信而有征	铁案如山	实地	实实在在	属实	如实	铁证如山	真确	真真切切	无可辩驳	无可争议	确确实实	毋庸讳言	毋庸置言	活脱	活脱脱
虚妄	无稽	荒诞	夸诞	荒诞不经	超现实	虚玄
影响	靠不住	莫须有	想当然	无凭无据
捕风捉影	镜花水月	水中捞月	空中楼阁	海市蜃楼	望风捕影	听风是雨
渺茫	渺	杳
逼真	乱真	传神	神似	逼肖	惟妙惟肖	活龙活现	绘声绘影	绘声绘色	栩栩如生	跃然纸上	呼之欲出	有鼻子有眼儿	以假乱真	绘影绘色	活灵活现	煞有介事	无差别	活脱	形神妙肖	活脱脱
疑似	似是而非	似真似假
失真	走样	畸变	画虎类狗	走形	畸
好	优	精	良	帅	佳	崭	美	妙	良好	大好	优良	精良	优秀	优异	精彩	出色	绝妙	漂亮	精美	美好	完美	美妙	精粹	精练	优质	上好	上上	理想	可以	地道	不含糊	了不起	呱呱叫	顶呱呱	可观	不错	够味儿	要得	尽如人意	完美无缺	尽善尽美	十全十美	白璧无瑕	妙不可言	名不虚传	有目共赏	有口皆碑	口碑载道	脍炙人口	交口称誉	好生生	好好	拔尖	说得着	得天独厚	过得硬	完好无损	有滋有味	两全其美	佳绩	出彩	上佳	甚佳	名特新优精	名特优新	名特优	醇美
高超	高强	高明	高妙	神妙	巧妙	精彩纷呈	精美绝伦	精彩绝伦	抢眼	俱佳	全优	无瑕	都行
精湛	深湛	精深	深邃	精辟	透辟	精湛不磨	博大精深
到家	过硬	高	深	强	巧	精	神	完	全	圣	硬	棒	通天	鬼斧神工	巧夺天工	出神入化	曲尽其妙	无出其右	骄人	超凡	独领风骚
瑰玮	瑰丽	郁郁	繁丽	谐美	妙曼	漂漂亮亮	娇美
锦心绣口	文不加点	一字千金	生花妙笔	掷地有声	百读不厌	洛阳纸贵
龙飞凤舞	好戏连台
字正腔圆	余音绕梁	地地道道
浮艳	艳
优越	优胜	优惠	优厚	优渥	优胜劣败	优于	优惠待遇	优化	有过之而无不及	特惠	价廉质优	从优
三好	品学兼优
坏	差	次	软	浅	破	糟	鬼	赖	孬	潮	不好	不良	不行	不妙	不善	差劲	稀松	糟糕	蹩脚	涂鸦	窳劣	二五眼	差点儿	驴鸣狗吠	次等	欠佳	不成	莠	二流	次于
不成话	要不得	一团糟	不足取	一无可取	一塌糊涂	看不上眼	不堪设想	不像话
恶劣	低劣	粗劣	卑劣	拙劣	猥陋	卑下	劣	恶	歹	劣质	伪劣	恶性	歹心	假劣
杰出	突出	出众	特异	卓著	卓越	卓绝	超绝	超群	超人	独立	卓然	拔尖儿	冒尖儿	数得着	数一数二	出人头地	出类拔萃	头角峥嵘	超尘拔俗	超群绝伦	鹤立鸡群	独占鳌头	首屈一指	名列前茅	至高无上	天下第一	登峰造极	百里挑一	超凡入圣	榜首	数不着	加人一等	人才出众	堪称一绝	一流	第一流	名列榜首	天下无双	独秀一枝	一枝独秀	一花独放	典型
不凡	非凡	别致	了不起	不简单	不同凡响	高视阔步	匪夷所思	卓尔不群	非同一般	出口不凡	气度不凡	不拘一格	身手不凡	惊世骇俗	超能	超自然	超导
空前	划时代	破天荒	史无前例	前无古人	前所未有	空前绝后	亘古未有	闻所未闻	见所未见	无先例	破格	前所未见
盖世	无双	无比	绝代	旷世	绝伦	独步	盖世无双	独一无二	绝无仅有	无可比拟	举世无双	惟一	绝世
异常	非常	异样	特别	特异	独特	特殊	特出	突出	出奇	奇异	奇特	特	殊	奇	异	新鲜	出格	独出心裁	异乎寻常	与众不同	特有	特种	例外	破例	新异	奇丽	超常规	非常规	不同寻常	非同寻常	非正规	离谱儿
奇崛	独到	不落窠臼	独树一帜	独具匠心	别具匠心	匠心独运	独辟蹊径	别开生面	别具一格	别有风味	别出心裁	独具特色	自成一家	自成一体	独具一格	匠心独具	异军突起	各具特色	特色牌
特定	一定
专门	专
唯一	绝无仅有	唯
普通	一般	平常	通常	寻常	便	日常	惯常	家常	常备	等闲	平凡	平淡无奇	司空见惯	习以为常	不足为奇	数见不鲜	一般性	不足为怪	常见	屡见不鲜	累见不鲜	平平常常	普普通通	一般而言	一般说来	万般
合格	够格	及格	过关	过得去	沾边	马马虎虎	通关
象样	不错	可以	可	不赖	不离儿	差不离	差强人意	看得过儿	沾边儿
瑕不掩瑜	大醇小疵	未可厚非
上等	上品	上流	上色	上等	上乘	上	优等	优质	甲	上档次
高等	高级	高档	尖端	高等级
头等	头号	一品	甲级	甲等	一等	一流	顶级	第一流	世界级	五星级
超等	超级	特等	特级	极品	上上	最佳	至上	顶尖	顶尖级
中等	中档	中级	中流	中游	中路	中	中间	当中	中不溜儿	高中级	高中档	中高档二档
平平	平常	平庸	寻常	中常	平凡	凡	瑕瑜互见	平淡无奇	不怎么样	不过如此	不过尔尔
下等	劣等	下品	低等	低档	低级	起码	等外	等而下之	中低档	中下	丙	初级
困难	艰难	繁难	万难	疑难	难	难于	为难	难人	作难	讨厌	棘手	缠手	扎手	辣手	吃力	费力	费劲	费事	费时	费难	费手脚	绕脖子	伤脑筋	谈何容易	来之不易	千难万难	难上加难	难于登天	寸步难行	积重难返	海底捞针	大海捞针	吃劲	烦难	患难	急难	费工	难办	难找	犯难	老大难	费工夫	举步维艰	创业维艰	万事开头难	高难	没法子	别无选择
艰巨	繁重	吃重	重	千斤	任重道远	疑难重症	一木难支
艰险	险	艰难险阻	荆棘载途	艰	千难万险
容易	简易	轻易	便当	易于	易	好	易如反掌	轻而易举	俯拾皆是	信手拈来	唾手可得	垂手而得	探囊取物	瓮中之鳖	手到擒拿	一挥而就	一蹴而就	一拍即合	迎刃而解	不费吹灰之力	瓮中捉鳖	手到擒来	好找	俯拾即是	不难
深奥	深邃	高深	渊深	艰深	精深	精微	古奥	简古	奥秘	奥博	深	微言大义	曲高和寡	赜
玄妙	奥妙	微妙	神妙	神秘	玄乎	玄	玄之又玄	神妙莫测	莫测高深	高深莫测	玄奥	神秘兮兮
费解	百思不解
浅近	浅显	浅易	粗浅	浅	通俗	平易	易懂	深入浅出	老妪能解	初步	达意
工整	工稳	工	整齐	齐整	工工整整	齐刷刷
通顺	通畅	通	流畅	畅达	明畅	晓畅	流利	明快	顺口	上口	顺理成章	文从字顺	琅琅上口	珠圆玉润	朗朗上口
晦涩	生涩	艰涩	涩	生硬	别扭	拗口	绕嘴	别别扭扭	隐晦
实际	现实	切实	求实	具体	言之有物	有血有肉	现实性	切切实实	切实可行	具象
实至名归	名符其实
空洞	空虚	虚空	空疏	虚无	悬空	架空	空虚	泛	空泛	肤浅	浮泛	泛泛	空幻	虚幻	迂阔	抽象	概念化	虚飘飘	虚无飘渺	不着边际	华而不实	纸上谈兵	言之无物	空空如也	肤泛	干瘪瘪	实而不华	虚无缥缈	空洞无物	无意义	失之空洞
全面	全盘	通盘	周全	周到	周至	周	到	圆	到家	两全	双全	十全	万全	健全	完善	完美	完满	圆满	一揽子	面面俱到	统筹兼顾	具体而微	应有尽有	包罗万象	森罗万象	无所不包	无微不至	一应俱全	宏观	尺幅千里	两手	百科
周密	严密	谨严	严谨	无懈可击	无隙可乘	天衣无缝	滴水不漏	多角度	多管齐下
片面	管窥	挂一漏万	一鳞半爪	东鳞西爪	断章取义	瞎子摸象	管窥所及	管中窥豹	窥豹一斑	坐井观天	畸轻畸重	断章取义	一面之词	以偏概全	盲人摸象	单边
正确	对	是	然	不错	无误	对头	得法	科学	不利	不易	无可非议	无可指责	无可争辩	无可置疑	毋庸置疑	颠扑不破	头头是道	天经地义	放之四海而皆准	正确性	是的	没错	无可挑剔	毋庸置言
准确	准	精确	确切	标准	规范	纯正	纯粹	可靠	靠得住	毫厘不爽	准确无误	准儿	高精度
箭不虚发	有的放矢	百发百中	百步穿杨	弹无虚发	百无一失	万无一失	十拿九稳	稳拿把攥
中肯	一语破的	一语道破	一针见血	言必有中	正中要害	识破天机	一语破的
错误	错	误	左	失实	不当	不对	荒唐	谬误	悖谬	荒谬	大谬不然	错误百出	大错特错	一无是处	百无一失	破绽百出	漏洞百出	张冠李戴	似是而非	背谬	缪	错谬
不足为凭	不足为训	靠不住	狗屁	盲目	脱误
笔误	误字
合理	有理	在理	象话	靠边	客观	成立	站住	站得住	说得过去	入情入理	合情合理	理所当然	情理之中	合理性	合理合法	合情	不无道理	客体
名正言顺	理直气壮	义正词严	振振有词	言之成理	顺理成章	天经地义	言之有理
无理	理亏	理屈	输理	勉强	主观	不科学	不合理	不合情理	说不过去	理屈词穷	师出无名	不攻自破	平白无故	无缘无故	岂有此理	莫名其妙	狗屁不通	无由
生硬	勉强	硬	强	生拉硬拽	生搬硬套	生吞活剥
牵强	凿空	牵强附会	穿凿附会	主观主义
勉强	将就	凑合	对付	结结巴巴	勉为其难	削足适履	勉勉强强	凑和
固定	恒定	永恒	铁定	一定	稳定	稳	恒	一贯	原则性	固化	定点	定位	锚固	定势	稳住
不变	静止	一成不变	原封不动	雷打不动	板上钉钉	不二价	划一不二	一如既往	一仍旧贯	依然如故	依然故我	以不变应万变	有序	言无二价	平平稳稳	稳步	平稳	数年如一	一动不动	文风不动
改头换面	换汤不换药	万变不离其宗	定型	千古不变	居高不下
灵活	活	活动	活络	机动	变通	回旋	权益	从权	权变	灵活机动	活字	活用	权宜	因地制宜	活泼泼
生动	潇洒	飘洒	活泼	活跃	活	栩栩如生	绘声绘色	绘影绘声	绘声绘影	有声有色	声情并茂	有血有肉	令人神往	穷形尽相	娓娓动听	颊上添毫	呼之欲出	跃然纸上	声泪俱下	情真词切	鲜活	图文并茂
平板	凝滞	呆滞	板滞	生硬	机械	拘泥	拘板	干巴巴	平铺直叙	僵滞	郁滞
猛烈	剧烈	强烈	酷烈	激烈	炽烈	热烈	利害	凌厉	激切	急剧	凶猛	狂暴	烈性	霸道	可以	翻天	熊熊	腾腾	汹汹	火炽	急	猛	凶	剧	烈	骄	冲	重	盛	毒	暴	狂	惨	锐	怒	狠	痛	霸气	火爆	烈烈
致命	沉重	殊死	决死	浴血
无情	毫不留情	水火无情
大张旗鼓	雷厉风行	雷霆万钧	轰轰烈烈	如火如荼	风起云涌	叱咤风云	暴风骤雨	急风暴雨	天崩地裂	飞砂走石	天翻地覆	地覆天翻	天旋地转	震天动地	移山倒海	泰山压顶	势如破竹	一往无前	势不可当	锐不可当	风卷残云	摧枯拉朽	劈头盖脸	泰山压卵	来势汹汹	气势汹汹	势不可挡	劈天盖地	撼天动地	大肆	隆重
尖锐	尖利	犀利	锐利	锋利	精悍	辛辣	尖刻	尖	舌剑唇枪	唇枪舌剑	尖酸刻薄	咄咄逼人	狠狠
过激	偏激
柔和	平和	温和	顺和	中和	和婉	轻柔	温柔	优柔	温情	和缓	平缓	和平	软和	软	文	缓	婉	和	温文尔雅	和风细雨	中庸	低缓	温婉	温软
深刻	深入	深切	尖锐	刻骨	透彻	透辟	深透	中肯	透	沦肌浃髓	刻骨铭心	铭心刻骨	铭肌镂骨	刻肌刻骨	入木三分	力透纸背	鞭辟入里	一针见血	一语道破	一语破的	谈言微中	深深	深深的	递进
高度	莫大	惊人	可观	冲天	万丈	入骨	彻骨
深远	远大	深长	隽永	幽婉	深	有意思	语重心长	微言大义	发人深省	耐人寻味	其味无穷	回味无穷	源远流长	意味深长	引人深思	发人深醒	耐人玩味	覃	甚笃	意犹未尽
深厚	深切	深刻	深湛	浓厚	深	厚	浓	天高地厚	山高水长	地久天长
恩同再造	恩重如山	再生父母
深沉	沉沉	透	深	沉	熟	酣	香	甜	香甜	府城	侯门如海
淡薄	淡漠	淡淡	淡	浅	淡化
肤浅	浮浅	浮泛	泛泛	皮毛	皮相	浅	蜻蜓点水	轻描淡写	走马看花	浮光掠影	浅尝辄止	只鳞片爪
轻微	微薄	菲薄	细微	微小	细小	分寸	轻	薄	一线
细腻	细致	入微	丝丝入扣	匀细
粗疏	粗线条	粗略	粗劣
稳固	牢固	坚固	巩固	坚实	结实	深厚	根深蒂固	深根固蒂	坚不可摧	坚如磐石	稳如泰山	固若金汤	金城汤池	牢不可破	稳步	坚牢	壁垒森严	钢铁长城	铜墙铁壁	铁打江山	不衰	长盛不衰
强大	强硬	强劲	强	劲	雄	精	精锐	无敌	有力	强有力	兵强马壮	所向无敌	所向披靡	一往无前	无往不胜	无坚不摧	攻无不克	战无不胜	泰山压顶	摧枯拉朽	降龙伏虎	兵不血刃	投鞭断流	人多势众	切实有力	雄强	船坚炮利	强压
强盛	富强	国富民强	繁荣富强	国富民安	民富国强	富国强兵
弱小	软弱	薄弱	虚弱	单弱	衰弱	微弱	贫弱	柔弱	衰微	弱	软	单薄	势单力薄	不堪一击	一触即溃	赤手空拳	手无寸铁	立足未稳	一虎势单	身单力薄
伟大	伟	鸿	弘	丕	壮	高大	宏大	远大	巨大	宏伟	英雄	光辉	皇皇	赫赫	了不起	惊天动地	顶天立地	震古烁今	补天浴日	光前裕后	气势磅礴	伟人	壮烈	广远	奇伟	恢
渺小	藐小	不起眼	看不上眼	不足道	微不足道	不在话下	不值一提	不屑一顾	不足挂齿	无足轻重	一文不值	一钱不值	沧海一粟	太仓一粟	九牛一毛
威武	威严	威风	赳赳	虎彪彪	堂堂	英武	英姿飒爽	英姿焕发	英姿勃勃	威风凛凛	八面威风	虎背熊腰	虎虎有生气	气概不凡	叱咤风云	龙腾虎跃	龙骧虎步	一呼百诺	气昂昂	虎虎生气	身高马大	人高马大	虎虎生威
雄壮	雄伟	宏伟	巍然	澎湃	壮阔	雄劲	粗豪	豪迈	滚滚	堂堂	磅礴	千军万马	万马奔腾	声势浩大	汹涌澎湃	波涌涛起	波澜壮阔	浩浩荡荡	气象万千	气冲霄汉	气贯长虹	气壮山河	气吞山河	轰轰烈烈	豪壮	壮美	倒海翻江	排山倒海	飞流直下三千尺	蔚为壮观	壮伟	万向	盛况空前
居高临下	高屋建瓴	蔚为大观	大气磅礴	气势磅礴	大观	洋洋大观
险要	险阻	险恶	险峻	关隘	虎踞龙盘	龙蟠虎踞	汹涌	激流汹涌	虎踞龙蟠
雄健	稳健	矫健	刚健	刚劲	苍劲	遒劲	苍劲	雄浑	浑厚	挺拔	峭拔	雄姿英发	雄峻挺拔	阳刚
奔放	豪放	恣意	纵横	无拘无束	一泻千里	挥洒自如	天马行空	纵横驰骋	龙飞凤舞	鸾飘凤泊	惊蛇入草	石破天惊	浑洒自如	龙翔凤翥	无羁无束	雄赳赳
光明	美好	晟	成气候	炜
清明	修明	夜不闭户	路不拾遗	秋毫无犯	鸡犬不惊
赏罚分明	信赏必罚	激浊扬清	彰善瘅恶	奖罚分明
黑暗	暗无天日	漆黑一团	一团漆黑	天昏地暗	昏天黑地	乌烟瘴气	乌七八糟	豺狼当道	道路以目	万马齐喑	敢怒而不敢言	天下乌鸦一般黑
腐败	腐化	腐朽	腐烂	尸位	尸位素餐	文恬武嬉	官官相护	贿赂公行	猫鼠同眠
光荣	荣耀	荣	荣誉	荣华	荣幸	光耀	体面	好看	体体面面	威兴我荣	无上光荣
不朽	永垂不朽	名垂青史	名垂千古	彪炳千古	彪炳史册	重于泰山	死得其所	万古流芳	流芳百世	流芳千古	青史名垂	彪炳春秋	千古不朽
衣锦还乡	荣宗耀祖	金榜题名	扬名天下
可耻	羞耻	无耻	丢人	丢脸	丢丑	难看	难听	愧赧	寒碜	丢面子	不要脸	不名誉	丢人现眼	见不得人	无耻之尤	恬不知耻	厚颜无耻	没皮没脸	奴颜婢膝	卑躬屈膝	丧权辱国	寡廉鲜耻	名誉扫地	威信扫地	斯文扫地	声名狼藉	臭名昭著	臭名远扬	遗臭万年	劣迹昭著	羞与为伍	不知羞耻	没脸	威风扫地	哀荣	掉价
著名	闻名	有名	知名	出名	老牌	名牌	头面	响当当	名	红	红得发紫	赫赫有名	举世闻名	闻名遐尔	鼎鼎大名	大名鼎鼎	如雷贯耳	出头露面	显赫一时	名噪一时	名震中外	举世瞩目	名满天下	名扬天下	尽人皆知	妇孺皆知	老少皆知	资深	饮誉	声名远播	广为人知	煊赫	名优特	甲天下	遐迩闻名	闻名遐迩	声震寰宇	极负盛誉	显赫	享誉
人心所向	众望所归	万流景仰	年高德劭	德高望重
无名	默默无闻	无声无臭	不见经传	默默	前所未闻	名不见经传	榜上无名
热门	吃香	叫座	时兴	热	红	俏	香	吃得开	紧俏	走俏	看好	人心向背	人人皆知	鹦鹉热	热点	抢手
冷门	冷	滞	背时	吃不开	无人问津	爆冷门
赢家	胜者	得主	胜利者
占上风	占优势
尊贵	高贵	显贵	显要	显达	上流	大	贵	权威	出将入相	有头有脸	高不可攀	惟它独尊	独尊	高于	胜过
贵	尊	雅	玉	台	华	令	贤	大	高	宝	钧	惠	光	俯	垂	高高	醇雅	俊雅
低贱	卑微	微贱	轻贱	贫贱	下贱	贱	卑微	低微	低下	卑下	卑鄙	寒微	卑	微	低	低人一等	低三下四	人微言轻
敝	鄙	拙	贱	寒	下	愚	家	舍	小
贵重	名贵	宝贵	可贵	华贵	珍贵	珍	珍奇	珍异	金玉	难得	难能可贵	不菲	弥足珍贵	玮
奇货可居	价值连城	价值千金	无价	珍稀
一刻千金	寸土寸金	寸草寸金
昂贵	腾贵	高昂	值钱	贵	米珠薪桂	质次价高
便宜	贱	廉	低廉	廉价	公道	惠而不费	价廉物美	物美价廉	最低价	价廉	质优价廉	价廉质优	低价
重要	紧要	要紧	主要	显要	首要	第一	要害	机要	重大	重点	要	要	根本	关键	非同小可	非同儿戏	举足轻重	一言九鼎	生死攸关	事关重大	至关紧要	重要性	重在	着重	最主要	国本	性命交关	至关重要	生命攸关	严重性	必不可缺	重中之重	命运攸关	任重而道远	利害攸关	基本点
中心	主导	主干	核心	中坚	骨干	基本	主从	挑大梁	着力	为重	为主
次要	其次	从	辅助	附带	副	下	附有	说不上	第二性
不足道	微不足道	微末	区区	无所谓	开玩笑	无可无不可	可有可无	鸡毛蒜皮	鸡零狗碎	无关紧要	无足轻重	不足挂齿	鸡虫得失	不屑一顾	不值一提	不过尔尔	不过如此
不要紧	没关系	没什么	没事儿	举重若轻
无伤大雅	无伤大体	无关大局	无关宏旨	无关痛痒	不痛不痒
紧急	紧迫	急迫	迫切	急切	火急	紧	急	亟	迫	急巴巴	十万火急	急如星火	火烧眉毛	燃眉之急	迫不及待	迫在眉睫	刻不容缓	间不容发	风风火火	时不我待	时不再来	事不宜迟	加急	情急之下
严重	惨重	深重	重	要紧	沉痛	不得了	不得了	人命关天	特重
惊人	可惊	震惊	触目惊心	惊心动魄	耸人听闻	危言耸听	动魄惊心	危辞耸听
必要	必需	少不得	少不了	短不了	必不可少	不可或缺	必备	缺一不可	画龙点睛
多余	富余	余	蛇足	画蛇添足	多此一举	净余	不必要	不消	冗	衍	用不着
熟识	熟悉	熟稔	稔知	面熟	面善	眼熟	耳熟	常来常往	熟知	谙熟
陌生	生疏	面生	眼生	耳生	生	非亲非故	素昧平生	人地生疏	生分	素不相识	来路不明	不谙
亲密	密切	亲切	亲近	接近	亲昵	亲热	相亲	亲爱	恩爱	热和	近乎	莫逆	知己	知心	贴心	亲	密	挚	近	不分彼此	亲密无间	形影不离	形影相随	相亲相爱	寸步不离	如胶似漆	水乳交融	如鱼得水	相见恨晚	相知恨晚	相依为命	心连心	心心相印	体贴入微	千丝万缕	情同手足	亲如手足	亲如兄弟	骨肉相连	血肉相连	促膝	亲亲	可亲	亲亲热热	亲如一家	亲亲切切的	丝丝缕缕
唇亡齿寒	唇齿相依	辅车相依	山水相连	如影随形	十指连心
鸾凤和鸣	鸳鸯戏水	夫唱妇随	白头偕老	比翼双飞
儿女情长	两小无猜	青梅竹马	耳鬓厮磨	卿卿我我
依恋	缠绵	缱绻	依依不舍	难舍难分	难解难分	打得火热	情景交融	难分难解
疏远	生疏	外道	远	疏	视同陌路	视同路人	敬而远之	亲疏	不可向迩
若即若离	不即不离
和睦	和气	和谐	谐和	调谐	谐调	协调	融洽	亲善	友善	友好	友爱	投机	要好	相好	和好	好	团结	自己	大团结	和和气气	人和	温馨	祥和	和乐	上下一心	对劲儿	阖家欢乐	团结一心	燮	谈得来	敦睦
不和	不对	不对劲	别扭	反目	同室操戈	别别扭扭	失和	积不相能
敌对	不共戴天	誓不两立	你死我活	冰炭不相容	敌视	鱼死网破	对抗性
紧密	严密	致密	密致	严紧	严谨	紧凑	连贯	接气	一体	紧	环环相扣	丝丝入扣	一环扣一环	紧紧	联贯	密不可分	密密的
松散	疏松	稀松	废弛	松	散	松松垮垮	松气	松松散散
单纯	单一	纯一	纯粹	纯净	十足	足色	纯	粹	单纯性
复杂	繁杂	冗杂	繁复	烦冗	纷繁	盘根错节	千头万绪	千丝万缕	错综复杂	犬牙交错	扑朔迷离	目迷五色	莫可名状	纵横交错	繁体	纷纭复杂	复杂性	茫无头绪	迷离扑朔	冗赘	卷帙浩繁	缛	苛
说来话长	一言难尽
重叠	臃肿	叠	层	叠床架屋	叠罗汉	重合	交汇	重重叠叠
琐碎	琐细	细碎	琐	繁缛	委琐	零碎	零星	鸡零狗碎	针头线脑	滴里嘟噜	零零碎碎
烦琐	繁芜	烦	麻烦	累赘	苛细	不胜其烦	繁琐
简单	简略	简约	简短	简易	简便	粗略	省略	简要	扼要	概括	大概	简捷	简明	简练	简	略	精炼	略去	简简单单	简便易行	简单易行	简而言之	简括	简言之	说白了	从略	一笔带过
详细	详尽	周详	祥	缕	不厌其详	详详细细	详实	事无巨细	细大不捐	详见	翔
透彻	透辟	透	淋漓	鞭辟入里	淋漓尽致	酣畅淋漓
均匀	匀称	匀净	匀溜	匀整	匀实	匀和	停匀	平均	均衡	平衡	匀	均	年均	户均	人均	随遇平衡	动态平衡	均一	人平
调和	调匀	协调	和谐	谐和
平衡	失衡
广泛	广阔	宽广	广大	宽泛	普遍	周边	广	泛	大	常见	科普	周遍	漫无止境	大规模	大面积
无穷	无限	无期	无边	无际	无边无际	无穷无尽	海阔天空	漫无边际	用不完	漫无际涯	一望无涯
狭隘	狭窄	窄小	狭小	窄	狭	小
丰富	丰厚	丰盛	丰硕	丰美	丰满	丰沛	富足	富饶	丰盈	雄厚	丰	富	足	充足	充裕	从容	充实	充分	充畅	充沛	丰赡	裕	取之不尽	繁博	富集	富于	横溢	宏赡	晟	沛	赡
广博	渊博	奥博	博	博大	盛大	博采众长	无所不有	地大物博	博识稔熟	恢宏博大	广袤	博闻强志
贫乏	缺乏	短小	不足	紧张	枯窘	枯竭	匮乏	青黄不接	左支右绌	捉襟见肘	挖肉补疮	匮
可爱	喜人	迷人	动人	宜人	媚人	可喜	可人	讨人喜欢	喜闻乐见	楚楚可怜	憨态可掬	容态可掬	纯情
明媚	柔媚
动人	感人	扣人心弦	动人心弦	感人肺腑	令人神往	引人入胜	沁人心脾	沁人肺腑	可歌可泣	回肠荡气	荡气回肠	振奋人心	顽石点头
可怕	怕人	吓人	骇然	骇人听闻	人言可畏	唬人
可憎	可恶	可恨	可鄙	讨厌	困人	恼人	烦人	该死	贫气	臭	丑	贫	碍手碍脚	令人作呕	面目可憎
伤	腻	腻烦	厌烦	倒胃口
深恶痛绝	千夫所指	不得人心
刺眼	碍眼
刺耳	难听	逆耳	牙碜	不堪入耳
可怜	可怜巴巴
可笑	好笑	喷饭	捧腹	贻笑大方	笑话百出	笑掉大牙	洋相	令人捧腹
有趣	风趣	诙谐	幽默	趣	好玩儿	有意思	妙不可言	妙趣横生	妙语如珠	饶有风趣	相映成趣	好玩	妙趣横溢	诙	盎然	俳
滑稽	好笑	哏	逗	逗笑儿	逗乐儿	逗乐
带劲	有劲	来劲	津津有味	津津乐道
枯燥	干燥	枯涩	乏味	无味	平淡	瘟	干瘪	干巴巴	味同嚼蜡	单调	没趣	平平淡淡	索然无味	没劲	没意思
正常	如常	健康	正规	常规	好好儿	好端端	正常化	见怪不怪	例行
反常	失常	畸形	乖谬	乖戾	错乱	尴尬	不对	不对头	不对劲	不规则	怪	邪	邪门儿	不是味儿	歇斯底里	颠三倒四	语无伦次	反常规	颠过来倒过去	邪乎	非正常	诡
怪癖	特别	怪僻	怪声怪气	非僧非俗
奇怪	古怪	诡怪	怪诞	希奇	希罕	新奇	奇妙	奇特	离奇	奇异	怪异	怪	奇	蹊跷	跷蹊	诡异	诡谲	见鬼	活见鬼	光怪陆离	千奇百怪	怪里怪气	古里古怪	怪模怪样	怪诞不经	刁钻古怪	无奇不有	闻所未闻	稀奇	稀奇古怪	好奇	奇幻	怪态	为怪	为奇	怪怪的
神奇	神异	瑰玮	神乎其神	神差鬼使
不伦不类	不三不四	非驴非马	莫名其妙
不可思议	天晓得	不知所云	不可名状
可疑	有鬼
公开	公然	明	明白	明文	当众	当面	大面儿上	桌面儿上	开诚布公	光天化日	当着	堂而皇之	自明	公诸于世	两公开	三公开	公之于世	四公开	明面儿
明目张胆	明火执仗
秘密	机密	绝密	机要	隐秘	神秘	诡秘	地下	潜在	私房	心腹	暧昧	暗昧	秘	私	密	黑	详密	贼溜溜	神秘兮兮	秘闻
暗中	暗暗	暗自	暗	冷	偷	私下里	私自	幕后	背后	背地里	暗地里	骨子里	悄悄	偷偷	鬼祟	鬼鬼祟祟	鬼头鬼脑	贼头贼脑	探头探脑	偷偷摸摸	不声不响	一声不响	秘而不宣	不露声色	不动声色	默默	潜	私下	体己	不可告人	悄悄的
合法	法定	官	官方
非法	不法	野鸡	私自	地下	越轨	私	黑	暗	伪	非官方	非法定
明显	显明	显著	昭著	昭彰	显然	显	阳	判	分明	明明	鲜明	明朗	明白	明了	简明	详明	醒豁	醒目	显目	显眼	扎眼	触目	眼看	明确	肯定	强烈	斐然	荦荦	明摆着	眼见得	显而易见	昭然若揭	黑白分明	彰明较著	有目共睹	众目昭著	众目睽睽	众所周知	妇孺皆知	尽人皆知	家喻户晓	举世瞩目	引人注目	一目了然	一览无遗	洞若观火	泾渭分明	不言而喻	无庸赘述	无可争辩	此地无银三百两	醒眼	溢于言表	大庭广众	赫	判若鸿沟	旗帜鲜明	拨云见日	确定性	昭昭	自不待言	吹糠见米
含糊	含糊	笼统	暧昧	模棱两可	含含糊糊	含混	含混不清	不明	泾渭不分	打眼
隐约	隐隐	隐隐约约	语焉不详	若隐若现	时隐时现	昭	倬
顶用	有用	中用	管用	合用	得力	顶事	管事	济事	使得	实用	实惠	有效	对症	灵验	灵光	灵通	灵	行	中	行之有效	立竿见影	可行	卓有成效	有效性	行得通
万能	全天候
两用	两栖
有功	功勋	劳苦功高	功德无量	居功
无用	无效	失效	无益	废	不行	空头	不济	不济事	无济于事	于事无补	以卵投石	与虎谋皮	杯水车薪	劳而无功	没用	行不通	低效	不算
口惠	只说不做	空口说白话	口惠而实不至	假大空
徒劳	枉然	徒然	徒	空	瞎	虚	干	白	乏	白搭	费力不讨好	为人作嫁	一事无成	鸡飞蛋打	画脂镂冰	白费力气	枉费心机	徒劳无功	海底捞月	水中捞月	螳臂当车	蚍蜉撼大树	问道于盲	缘木求鱼	画饼充饥	望梅止渴	隔靴搔痒	纸上谈兵	对牛弹琴	扬汤止沸	贼去关门	蚍蜉撼树	徒劳无益	劳而无获
无偿	义务	无条件	白	分文不取	白白	义诊
便利	便当	便	方便	省便	省事	轻便	简便	近便	稳便	灵便	活便	便捷	近水楼台先得月	便民	地利	简便易行	两便	省心
手提式	手提
不便	麻烦	为难	难以	未便	碍事	碍难	难	碍口	碍手碍脚	难以启齿
恰当	适当	得当	切当	允当	精当	相当	适宜	合宜	相宜	得宜	适合	合适	正好	确切	贴切	妥帖	熨帖	平妥	对头	对路	得体	对劲	方便	适度	适量	适中	恰	宜	当	适	有分寸	恰如其分	恰到好处	适可而止	哀而不伤	不为已甚	适龄	适用	适于	宜于	当令	恰切	老少咸宜	妥
各得其所	因地制宜	因人制宜	因时制宜	人尽其才	物尽其用
适时	及时	适逢其会	不冷不热	可巧	不违农时
切题	照理
合身	称身	可身	可体	合体
适口	合口味	下饭	下酒	归口	专业对口
失当	不当	失宜	不宜	驴唇不对马嘴	着三不着两	不力
文不对题	不妥	欠妥
屈才	大材小用	牛鼎烹鸡
以珠弹雀	明珠弹雀
妥当	妥善	停妥	妥实	服帖	稳妥	稳便	稳	稳当	停当	就绪	四平八稳	千了百当	计出万全	服服帖帖	纹丝不动	稳稳当当
可靠	牢靠	牢稳	保险	笃定	把稳	吃准	靠得住	十拿九稳	百无一失	稳操胜券	稳操左券	稳拿把攥
天然	自然	天生	天赋	天禀	先天	生就	原始	天	原	生	自发	原貌	原状	原生态	纯天然	先天性	任其自然
天衣无缝	行云流水
本来	原来	原本	原有	固有	故	旧	老	初	原	原始	土生土长	本来面目
现成	现	成	备
外来	外路	洋	番	夷	海	胡	旗	西
国产	国	华
土产	土
正规	正式	正经	正统	规范	标准	专业	科班	明媒正娶	正儿八经	正规化	业内
业余	非正式	脱产
课余	课外
杂牌	杂色
分内	本分	本职	当仁不让	理所当然	义不容辞	非君莫属	责无旁贷	匹夫有责	义无返顾	在所不辞	本本分分
分外	格外	额外	附加	外加
公	公共	官	集体	大我	公家	公私	公物	国有	共用
村务公开	半公开
私	私房	私有	个人	村办	个体	民用	私家	个私
总	主	本	千	母	宏观
分	支	岔	旁	子	分支	拨出	道岔	支行	汊港	分段	岔开	隔开	分层
御	钦	上	敕	圣	龙	宸	天
皇	国	皇家	三皇
禅	梵	佛	僧	衲	武僧
胞	同胞	亲生	血亲	嫡亲	嫡	冢
堂	堂房	嫡堂	叔伯	同房	从
表	中表
姑表	姑舅
姻	内	外	舅
寄	养	义	干
继	后	晚	后继
庶	旁支	桑寄生
师	砚	学
盟	把	拜把
这个	这	此	斯	是	之	者	夫	其一	以此	本条
那个	那	彼	其	恁	该	夫	其二
某个	某	某某	有	某部	之一
各个	各	列	诸	每	各国	各级
其他	其它	其余	别	别样	另外	外	另	旁	另一个	任何
异	他	外	客
何	什么	底	啥	吗	甚
善良	善	好	乐善好施	助人为乐	仁至义尽	臧
仁慈	仁爱	慈善	慈祥	慈悲	慈	仁	脸软	手软	心慈面软	慈眉善目	大慈大悲	菩萨心肠	慈爱	慈和	仁义	爱心	心慈手软
凶恶	凶狠	凶横	凶暴	强暴	横暴	凶悍	邪恶	恶	凶	恶狠狠	杀气腾腾	咬牙切齿	凶相毕露	穷凶极恶	金刚努目	横眉怒目	横眉竖眼	龇牙咧嘴	青面獠牙	张牙舞爪	丑恶	凶狂	狰狞	立眉瞪眼
恶毒	狠毒	刻毒	歹毒	毒辣	辣手	黑心	狠心	狠	毒	辣	心黑手辣	心狠手辣	杀人不见血	如狼似虎	豺狼成性	丧尽天良	丧心病狂	伤天害理	惨无人道	惨绝人寰	嗜杀成性	灭绝人性	赶尽杀绝	杀人如麻	杀人不眨眼	惨毒	不人道	伤天害命	为富不仁	毒辣辣	不顾死活
人面兽心	狼心狗肺	狠心肠	狠心狼
罪恶	万恶	十恶不赦	怙恶不悛	罪大恶极	罪恶昭著	罪孽深重	罪该万死	作恶多端	恶贯满盈	五毒俱全	死有余辜	罪不容诛	罪恶滔天
祸国殃民	草菅人命
凶残	残酷	残暴	残忍	暴虐	酷虐	暴戾	酷	暴戾恣睢	残酷无情	残酷无情
阴险	险恶	阴	险	贼	阴毒	阴骘	凶险	险诈	阴险毒辣	用心险恶	居心叵测	心怀叵测	包藏祸心	借刀杀人	人心惟危	笑里藏刀	口蜜腹剑	佛口蛇心	两面三刀	奸险	见风转舵	虎视眈眈
厚道	忠厚	敦厚	温厚	仁厚	宽厚	憨厚	笃厚	淳厚	浑厚	人道	浑朴	淳朴	纯朴	诚朴	朴实	忠厚老实	不念旧恶	以德报怨	息事宁人	隐恶扬善	古道热肠	憨直	厚朴	朴	以直报怨	憨	拙朴	醇朴	淳	恽	忍辱求全
刻薄	苛刻	尖刻	忌刻	冷峭	尖酸	尖酸刻薄	严苛
嘴尖	贫嘴	尖嘴薄舌	轻口薄舌	话里带刺	幸灾乐祸
缺德	不仁	不仁不义	无仁无义	恩尽义绝	不道德	苛
正直	耿直	刚直	戆直	刚正	方正	中正	纯正	雅正	矢	刚正不阿	大义凛然	耿	鲠直	伉	谠	梗直	胸无城府	铮	刚直不阿
坦率	坦白	磊落	襟	光明正大	光风霁月	问心无愧	明公正道	敢作敢为	堂皇正大	坦诚	胸怀坦荡	正大光明	光明磊落	襟怀坦白	坦陈	赤裸
直率	率直	直爽	爽直	爽快	朴直	直截	简捷	干脆	痛快	干	直	脆	露骨	公然	赤裸裸	直截了当	说一不二	开门见山	痛快淋漓	单刀直入	百无禁忌	直言不讳	无庸讳言	打开天窗说亮话	直捷	坦承
豪爽	爽朗	粗豪	粗犷	快	直性子	直肠子	有嘴无心	直来直去	慷
嘴快	心直口快	有口无心	开宗明义
婉转	委婉	婉约	婉言	婉	含蓄	缓和	宛转
转弯	绕圈子	兜圈子	绕弯儿	转弯抹角	拐弯抹角	藏头露尾	旁敲侧击	绕弯子	转弯子
含糊其辞	支吾其词	欲言又止
话里有话	意在言外	另有所指	指东说西	指桑骂槐
诚实	老实	规矩	信实	平实	朴质	心口如一	表里如一	表里一致	言行一致	说一不二	言而有信	信誓旦旦	敦	赤诚	恳	老老实实	朴	情真意挚	坦诚相见	推诚相见	仗义
刁滑	狡猾	狡狯	狡黠	奸猾	奸邪	奸佞	刁钻	刁悍	刁顽	奸诈	狡诈	谲诈	诡诈	诡谲	刁	奸	别有用心	居心不良	口是心非	老奸巨猾	诡计多端	狡兔三窟	老奸巨滑
势利	势利眼	重富欺贫	欺软怕硬	畏强欺弱	惟利是图
真诚	热诚	至诚	赤忱	虔诚	竭诚	精诚	诚挚	诚笃	诚恳	恳切	纯真	真挚	恳挚	深挚	真率	率真	义气	诚心	实心	真心	倾心	衷心	由衷	真切	热切	殷切	殷殷	谆谆	拳拳	诚	真心诚意	诚心诚意	真心实意	实心实意	开诚相见	开诚布公	肝胆相照	披肝沥胆	口陈肝胆	推心置腹	挚诚	拳拳之心	谌
虚伪	伪善	假	两面派	假惺惺	巧言令色	假仁假义	阳奉阴违	虚与委蛇	虚应故事	猫哭老鼠	鳄鱼眼泪	弄虚作假	假眉三道	道貌岸然
忠诚	忠	笃	忠贞	忠实	笃实	忠心耿耿	披肝沥胆	忠贞不二	赤胆忠心	忠骨	忠于	忠于职守
叛逆	忤逆	逆	异	贰	大不敬	大逆不道	六亲不认	离经叛道	忤逆不孝	愚忠	不孝	忤
温柔	温和	温存	温润	和气	和善	和易	和蔼	和约	平易近人	好说话儿	好声好气	和颜悦色	和蔼可亲	和和气气	和悦	亲和
暴躁	暴烈	火性	粗暴	暴	暴	躁	烈
温顺	和顺	恭顺	忠顺	驯顺	驯熟	驯服	驯良	柔顺	随和	乖	百依百顺	与人无争	一团和气	温驯	驯熟
听话	听说	听从	俯首帖耳	惟命是从	奉命唯谨	言听计从	唯唯诺诺	唯命是从	千依百顺	奉命唯谨
孝顺	孝
倔强	倔	犟	拗	倔头倔脑	犟头犟脑	倔犟	犟劲
不甘	不甘心	不甘示弱	不甘寂寞
乖僻	乖张	乖戾	桀骜不驯
乐观	乐天	达观	开朗	开阔	开豁	开展	明朗	想得开	无忧无虑	自得其乐	乐天知命	知足常乐	逍遥自得	以苦为乐	乐观主义	有望
悲观	想不开	郁郁寡欢	悲观失望	杞人忧天	听天由命	万念俱灰	心如死灰	槁木死灰	不容乐观
严肃	严厉	严峻	凛然	俨然	愀然	正色	厉声	一本正经	凛若冰霜	不苟言笑	声色俱厉	疾言厉色	正襟危坐	凛	义正辞严	正颜厉色	肃然	正气凛然	肃
活泼	活跃	欢	欢跃	生动活泼	生气勃勃	生龙活虎	欢蹦乱跳	龙腾虎跃	生意盎然	一片生机	虎虎有生气	外向	活蹦乱跳	活泼泼
顽皮	调皮	皮	淘气	顽
潇洒	洒脱	洒落	跌宕	翩翩	飘逸	风流	自然	大方	落落大方	葛巾羽扇	指挥若定	潇洒不羁	俊发飘逸	侠气
豪放	不羁	豪爽	超脱	旷达	豪放不羁	爽利	慷	慨
拘束	拘谨	矜持	局促	拘板	拘礼	拘泥	腼腆	束手束脚	缩手缩脚	扭扭捏捏	局促不安
消遥	自在	自得	消遥自在	悠闲自在	无拘无束	悠哉游哉	自由自在	自得其乐	逍遥	无羁无束
安分	本分	规矩	老实	安分守己	安守本分	循规蹈矩	规行矩步	老实巴交	随遇而安	安贫乐道	与世无争	浑俗和光	和光同尘	奉公守法	既来之	本本分分	规规矩矩
放肆	放纵	放诞	猖狂	猖獗	嚣张	恣意	恣肆	非分	骄纵	骄横	狂妄	狂	愚妄	浪	胆大妄为	恣意妄为	自作主张	随心所欲	为所欲为	无法无天	目无法纪	目中无人	肆无忌惮	百无禁忌	毫无顾虑	旁若无人	有恃无恐	有天没日	明目张胆	明火执仗	横行无忌	胡作非为	失态	肆无忌弹	张扬	甚嚣尘上	群龙无首	招摇	不顾一切	狂妄自大
散漫	疏懒	随便	不在乎	无所谓	大大咧咧	松松垮垮	吊儿郎当	从心所欲	大咧咧	随随便便
放荡	荒唐	放荡	放浪	放浪形骸	放荡不羁	落拓不羁	不拘小节	玩世不恭	不修边幅	浪荡	毫无顾忌
果断	决断	果敢	果决	坚决	泼辣	毅然	决然	断然	毅然决然	大刀阔斧	快刀斩乱麻	干脆利落	当机立断	毫不犹豫	二话不说
坚强	刚强	顽强	钢铁	不屈	刚烈	刚直	刚毅	沉毅	强项	硬气	烈性	血性	血气	烈	硬	刚	百折不挠	百炼成钢	威武不屈	坚强不屈	坚贞不屈	宁死不屈	不屈不挠	万死不辞	铮铮铁骨	百折不回	不折不挠	穷当益坚	身残志坚	宁为玉碎	毅	忠贞不屈	坚毅不屈
刚柔相济	绵里藏针	疾风劲草	铁石心肠	硬性
坚定	坚	坚决	死活	坚忍	坚贞	坚忍不拔	矢志不移	有志竟成	锲而不舍	斩钉截铁	海枯石烂	坚定不移	破釜沉舟	岿然不动	雷打不动	木人石心	精卫填海	铁板钉钉	坚苦	坚韧不拔	执著	坚毅	坚劲	坚贞不渝	万劫不渝	生死不渝	不懈	意志力
脆弱	软弱	薄弱	懦弱	软	婆婆妈妈	娇生惯养	耳软心活	懦	意志薄弱者
勇敢	勇	敢	勇于	敢于	英勇	骁勇	神勇	勇猛	勇武	英武	英雄	大胆	斗胆	胆大	剽悍	强悍	大无畏	一身是胆	胆大包天	群威群胆	奋不顾身	赴汤蹈火	出生入死	舍生忘死	视死如归	万死不辞	临危不惧	无所畏惧	了无惧色	履险如夷	身先士卒	万夫莫当	神威	首当其冲	挺身	无畏	披荆斩棘	劈风斩浪	匹夫之勇	破马张飞	打抱不平	奋勇	奋勇当先	虎劲	急流勇进	见义勇为	不避艰险	飒爽	骁	有种	不怕牺牲	威猛	竟敢
有勇有谋	大智大勇	智勇双全	越战越勇
怯懦	怯弱	愚懦	胆小	胆虚	胆怯	卑怯	怯生生	心虚	草鸡	窝囊	孬	胆小如鼠	胆小怕事	畏首畏尾	缩头缩脑	钳口结舌	唯唯诺诺	怯声怯气	贪生怕死	苟且偷安	不敢越雷池一步	矫	缩头	憷头	怯	委曲求全
聪明	聪慧	明慧	智慧	聪颖	颖悟	灵性	颖慧	慧黠	内秀	明白	智	小聪明	秀外慧中	耳聪目明	足智多谋	大智若愚	聪敏	生财有道	有头有脑	聪明伶俐	大巧若拙	多谋善断	颖慧	精明能干	灵气	隽	能者	早慧	融智
过目不忘	过目成诵	一目十行	才思敏捷
英明	明智	睿智	精明	神	料事如神	独具只眼	明察秋毫	见微知著	金睛火眼	睿	英名盖世
愚笨	笨拙	拙笨	迂拙	愚蠢	愚笨	愚拙	愚鲁	愚昧	痴呆	呆笨	粗笨	傻气	傻劲儿	笨	拙	痴	蠢	愚	傻	傻呵呵	傻里傻气	愚不可及	愚昧无知	昏头转向	买椟还珠	骑马找马	缺心眼儿	傻乎乎	不灵	蠢笨	蠢物	舍珠买椟	懵	昏昏然	愚钝	弱质	五音不全
糊涂	悖晦	发蒙	蒙昧	懵懂	颟顸	马大哈	暗	昏庸	昏聩	糊里糊涂	稀里糊涂	昏头昏脑	浑头浑脑	晕头转向	蒙头转向	迷迷糊糊	如堕烟海	如坐云雾	如堕五里雾中	当局者迷	胡涂	聪明一世
机智	机灵	机敏	机警	灵巧	灵敏	灵活	精灵	玲珑	机巧	乖巧	乖觉	敏锐	锐敏	敏感	伶俐	灵	快	随机应变	临机应变	通权达变	便宜行事	见机行事	手急眼快	相机行事	牙白口清	眼捷手快	人杰地灵	聪	急智	能屈能伸	千伶百俐	聪明伶俐	耳听八方	敏锐性	灵动	趁机	能进能出
鲁钝	迟钝	顽钝	驽钝	呆笨	呆	木讷	讷讷	呆头呆脑	张口结舌	笨口拙舌	笨手笨脚	木雕泥塑	泥塑木雕	木头疙瘩	怯头怯脑	呆傻	呆愣愣	痴呆呆	呆呆地
圆滑	浑圆	油滑	世故	两面光	八面玲珑	随大溜	随风倒	随波逐流	见风使舵	随风转舵	鉴貌辨色	人云亦云	灵活性	看人下菜	八面光	混水摸鱼	看风使舵
滑头	油	滑	油头滑脑	滑头滑脑	聪
油嘴	油腔滑调	油嘴滑舌	轻嘴薄舌	顺风转舵
刻板	古板	死板	呆板	死	板	一板一眼	板板六十四	划一不二	依样画葫芦	胶柱鼓瑟	刻舟求剑	守株待兔	按图索骥	食古不化	率由旧章	毒化	死脑筋	死心塌地	固执己见	不到黄河心不死	不识抬举	拘于	姜太公钓鱼
教条	机械	公式化	教条主义	本本主义	照本宣科	形而上学
固执	执拗	愚顽	顽固	死硬	僵硬	顽梗	执着	刚愎	刚愎自用	一个心眼儿	顽固不化	泥古不化	师心自用	自以为是	一意孤行	执迷不悟	至死不悟	不识时务	讳疾忌医	屡教不改	秉性难移	自行其是	偏执
灵巧	灵活	灵	巧	活	灵便	灵敏	圆通	手巧	麻利	利索	利落	活络	心灵手巧	新巧	眼疾
心灵	眼尖	手快	眼明手快	手疾眼快	眼疾手快	快人快语
能干	精干	精悍	得力	贤明	英明	高明	能	行	成	有两下子	精明强干	神通广大	游刃有余	教子有方	有方	技高一筹	技压群雄	领导有方	精明能干
全能	万能	无所不能	全知全能	文武全才	文武双全	多才多艺	左右开弓	一专多能	能文能武	能者为师	能者多劳
善战	以一当十	用兵如神	胆识过人	短小精悍
妙手回春	手到病除	起死回生	起手回春
健谈	对答如流	口若悬河	巧舌如簧	能言善辩	辩才无碍	语惊四座	伶牙俐齿
独具慧眼	独具只眼	慧眼独具
出口成章	文不加点	一挥而就	下笔成章	妙语连珠
无能	低能	差劲	庸碌	平庸	凡庸	碌碌	碌碌无能	志大才疏	一无所长	尸位素餐	弱智	庸庸碌碌	经营不善	高分低能
博学	饱学	宏达	博学多才	博大精深	博古通今	博览群书	见多识广	学有专长	无所不知	满腹经纶	满腹珠玑	博闻强记	才高八斗	陆海潘江	金玉满堂	通今博古	博闻强识	博雅	才华横溢	硕学
浅学	浅薄	浅陋	鄙陋	半瓶醋	半吊子	才疏学浅	略识之无	浅尝辄止	不求甚解	谫
孤陋寡闻	少见多怪	蜀犬吠日	识文断字
无知	蒙昧	愚昧	愚蒙	愚陋	混沌	愚昧无知	一无所知	一窍不通	一问三不知	目不识丁	胸无点墨	不学无术	漆黑一团	冥顽不灵	浑浑噩噩	不辨菽麦	五谷不分	浑沌一片	蚩	发懵
有为	成器	成材	年轻有为	奋发有为	大有作为	大有可为	前程似锦	前程万里	鹏程万里	前途无量	春秋正富	春秋鼎盛	壮志凌云	孺子可教	后生可畏	大器晚成	老骥伏枥	有所作为	成才	得道多助	老有所为	前程锦绣
不成材	不成器	没出息	碌碌	不可救药	碌碌无为	无所作为	不务正业	不郎不秀	累教不改	邪门歪道	胸无大志	不稂不莠
卓有远见	目光如炬	高瞻远瞩	志在千里	鸿鹄之志
目光如豆	目光短浅	鼠目寸光	近视	坐井观天	不识大体	饮鸩止渴	急功近利	求田问舍	散光	有眼无珠	鸡口牛后	鸡尸牛从	短视
老练	干练	老到	老成	老气	老辣	老	练达	成熟	老谋深算	深谋远虑	老成持重	少年老成	曾经沧海	饱经风霜	老马识途	老于世故	老道	早熟	多谋善算者
幼稚	天真	纯真	稚气	娇憨	孩子气	天真烂漫	天真无邪	没深没浅	没心没肺	痴人说梦	娇痴	稚嫩	童心未泯	童真
少不更事	羽毛未丰	乳臭未干	初出茅庐	涉世不深	稚气未脱
熟练	纯熟	娴熟	圆熟	烂熟	熟	纯	稳练	谙练	在行	内行	懂行	见长	训练有素	科班出身	滚瓜烂熟	炉火纯青	目无全牛	游刃有余	驾轻就熟	运用自如	挥洒自如	如臂使指	得心应手	滚瓜流油	熟能生巧	自如	运用裕如	融汇贯通
生疏	夹生	生	外行	半路出家	生僻
荒疏	荒
积极	主动	肯干	干劲冲天	知难而进	力争上游	再接再厉	当仁不让	积极性	能动	积极向上
消极	被动	消沉	低沉	低落	无所作为	听天由命	得过且过	与世无争	看破红尘	四大皆空	甘居中游	知难而退	做一天和尚撞一天钟	半死不活
勤奋	勤勉	勤劳	勤恳	勤快	勤谨	勤	手勤	勤苦	辛勤	努力	奋勉	巴结	孜孜不倦	笃行不倦	卧薪尝胆	栉风沐雨	吃苦耐劳	不辞辛劳	不辞劳苦	任劳任怨	摩顶放踵	事必躬亲	身体力行	发愤忘食	废寝忘食	笨鸟先飞	精卫填海	磨杵成针	锲而不舍	有志竟成	下大力	勤俭持家	忘我工作	勤于	卖劲	懋
闲不住	戴月披星	夜以继日	日以继夜	焚膏继晷	争分夺秒	分秒必争	见缝插针	只争朝夕	夙兴夜寐	朝乾夕惕	不辞辛苦	勒石记痛	早出晚归	孜孜	孜孜以求	起早贪黑	勤奋好学	勤勤恳恳	尽瘁鞠躬	刻苦耐劳	发愤	奋发进取	不畏难辛
用功	用心	笃学	好学	苦读	苦学	啃书本	手不释卷	十年寒窗	学而不厌	勤学苦练	目不窥园	无日无夜	下功夫	悬梁刺股	十年一剑	十年磨一剑	较劲
懒惰	懒	懒散	懈怠	怠惰	窳惰	好吃懒做	好逸恶劳	四体不勤	拈轻怕重	悠悠忽忽	饱食终日	无所用心	游手好闲	见缝就钻	饭来张口	懈	惰
拖拉	拖沓	疲沓	拖泥带水	疲沓	拖三拉四	拖拖拉拉
有恒	恒久	持久	有始有终	善始善终	愚公移山	持之以恒	全始全终	始终如一	坚持不渝	始终不渝	锲而不舍	滴水穿石	水滴石穿	磨杵成针	绳锯木断	持久	持之有故	坚持不懈	始终不懈	有头有尾	从始至终	慎始而敬终	慎始敬终	由始至终	从头到尾	一抓到底
无恒	有始无终	有头无尾	虎头蛇尾	断断续续	一暴十寒	断续	时断时续
节约	节省	省	俭省	俭朴	节俭	刻苦	朴素	节衣缩食	缩衣节食	克勤克俭	省吃俭用	箪食瓢饮	粗茶淡饭	精打细算	宽打窄用	细水长流	开源节流	量入为出	坚苦	节能	厉行节约	勤俭	勤俭节约	勤政	省力	勤政廉政	省时	勤政廉洁	廉政勤政	节电	俭	粗衣淡食	省却	廉洁勤政	仔细
奢侈	浪费	铺张	奢靡	奢华	糜费	挥霍	铺张浪费	穷奢极侈	骄奢淫逸	大手大脚	一掷千金	千金一掷	挥金如土	暴殄天物	大吃大喝	花天酒地	纸醉金迷	金迷纸醉	灯红酒绿	醉生梦死	酒池肉林	锦衣玉食	钟鸣鼎食	轻裘肥马	奢	奢侈浪费	奢糜	大操大办	侈
认真	顶真	较真	负责	一本正经	正经八百	事必躬亲	一丝不苟	呕心沥血	敬业	恪尽职守	爱岗敬业	动真格	敬业爱岗	精研细磨	认认真真	兢	较真儿
马虎	含糊	草率	潦草	草	草草	浮皮潦草	虚应故事	漫不经心	掉以轻心	丢三落四	粗制滥造	偷工减料	肤皮潦草	含含糊糊	不负
仔细	细	过细	细致	细密	缜密	致密	周密	绵密	密切	精到	精心	细心	心细	精雕细刻	细针密缕	条分缕析	胆大心细	逐字逐句	仔仔细细	有心人	明细	细瞧	细致入微	严细
粗心	粗	粗率	粗疏	疏忽	失慎	马大哈	粗枝大叶	缺心少肺	粗心大意	疏于	虎气
毛手毛脚	没头没脑
谨慎	勤谨	严谨	谨	审慎	当心	小心	小心谨慎	小心翼翼	谨言慎行	字斟句酌	谨小慎微	奉命唯谨	战战兢兢	兢兢业业	临深履薄	三思而行	谨而慎之	兢	竞	毖
口紧	嘴紧	嘴稳	守口如瓶	三缄其口
慎重	郑重	郑重其事
知趣	识趣	识相
轻率	鲁莽	莽撞	冒失	冒昧	孟浪	造次	贸然	率尔	唐突	愣	愣头愣脑	率尔操觚	视同儿戏	不知死活	不知进退	不管不顾	不管三七二十一	猴手猴脚	卤莽	鲁	冒失鬼	不慎	一不小心	出言不慎	稍有不慎
荒唐	荒诞
稳重	稳健	沉稳	把稳	持重	庄重	凝重	庄严	端庄	端详	安详	安稳	老成持重	不苟言笑	四平八稳	宠辱不惊	举止端庄	俨	拙朴
踏实	塌实	扎实	朴实	实在	脚踏实地	步步为营	稳扎稳打	一步一个脚印儿	踏踏实实	安安稳稳	朴	实干	扎扎实实	沉实	照实	一步一个脚印
轻浮	浮	漂浮	轻飘	轻狂	张狂	轻举妄动	心浮	虚浮
耐心	耐性	耐烦	诲人不倦	不厌其烦	苦口婆心
苦心	煞费苦心	苦心孤诣	煞费心机
急躁	浮躁	褊急	急性	性急	操切	操之过急	气急败坏	毛躁	欲速不达	不耐烦	心浮气躁	躁动	躁动不安
文雅	风雅	娴雅	清雅	儒雅	文明	文静	娴静	秀气	斯文	大方	雍容	文绉绉	文质彬彬	彬彬有礼	温文尔雅	风度翩翩	曲水流觞	山清水秀	文明礼貌	文武	文文静静	彬	彬彬	斌
粗暴	粗鲁	粗犷	犷悍	粗野	粗	野	野蛮	狂暴	不逊	粗里粗气	村野	老粗	强行	蛮荒
清高	孤高	孤傲	淡泊	恬淡	出世	脱俗	超脱	超逸	与世无争	洁身自好	落落寡合	特立独行	孤芳自赏	超然物外	富贵浮云	淡泊名利
虚荣	好胜	爱面子	好高骛远	好大喜功	沽名钓誉	好强	眼高手低	讲面子
恭敬	虔敬	恭谨	尊敬	尊重	敬	拜	肃然起敬	毕恭毕敬	相敬如宾	举案齐眉	正襟危坐	必恭必敬	恭	恭恭敬敬	可敬	虔	寅
敬老	尊老敬老	尊老	敬老养老
客气	殷勤	殷	宾至如归	客客气气	却之不恭
简慢	怠慢	轻慢	非礼	失礼	不周	毫不客气	怠	索然
热情	热心	热忱	热心肠	好客	满腔热忱	古道热肠	有求必应	来者不拒	急人之难	急人所急	满腔热情	满怀深情	热情洋溢	善款
冷淡	冷漠	冰冷	淡漠	淡然	淡淡	淡	冷	冷冰冰	冷言冷语	阴阳怪气	似理非理	漠不关心	冷眉冷眼	生冷	冷酷	漠然	漠然视之	见外	冷艳	冷峻
谦虚	谦逊	谦恭	谦卑	谦和	过谦	虚心	客气	谦虚谨慎	虚怀若谷	不耻下问	闻过则喜	功成不居	劳不矜功	谦
深藏若虚	大智若愚	自豪	兼听则明	居功不傲	不卑不亢	不骄不躁	不亢不卑	淡泊明志	超然
自卑	卑	妄自菲薄	自轻自贱	自惭形秽
恭顺	低声下气	低三下四	低首下心	奉命唯谨	唯唯诺诺	卑躬屈膝	摇尾乞怜	奴颜媚骨	奴颜婢膝	目不见睫	媚颜
骄傲	骄矜	矜夸	骄	满	傲	傲慢	骄慢	神气	高傲	傲视	傲岸	自负	自居	自夸	自用	自是	自大	孤高	不自量力	翘尾巴	自高自大	自以为是	骄傲自满	居功自傲	妄自尊大	好为人师	夜郎自大	不可一世	自命不凡	惟我独尊	旁若无人	目中无人	目无余子	目空一切	锋芒毕露	盛气凌人	呼幺喝六	老气横秋	倚老卖老	恃才傲物	有恃无恐	大言不惭	出言不逊	得意忘形	忘乎所以	顾盼自雄	耀武扬威	趾高气扬	神气活现	颐指气使	高视阔步	大模大样	老虎屁股摸不得	作威作福	倨	自满	自傲	煞有介事	自不量力	轻世傲物	傲然	目指气使	居功自恃	不自量	冷傲	倨傲不恭	唯我独尊	矜	冲昏头脑	狂傲	洋洋自得	人莫予毒
引以自豪	成就感
大度	大量	大方	大气	雅量	豁达	旷达	恢宏	不念旧恶	满不在乎	豁达大度	汪洋	大大方方	气势恢宏	坦坦荡荡
慷慨	慨然	侠义	舍己为人	急公好义	先人后己	慨当以慷	豁朗	舍己为公	舍身为国	舍已为公	慷	慷慨大方	不吝
够交情	够朋友
手松	大方	不在乎	大手大脚
心窄	小心眼	小肚鸡肠	鼠肚鸡肠	鸡肠鼠肚	不够意思
吝啬	悭吝	鄙吝	贫气	手紧	小气	抠	钱串子	小手小脚	小家子气	小儿科	斤斤计较	分斤掰两	掂斤播两	数米而炊	一毛不拔	铁算盘	啬	抠门	抠抠搜搜
严格	严厉	严酷	严峻	严	从严	严词	执法必严	严苛	严细	从紧	严加	适度从紧
军令如山	执法如山	言出法随	令行禁止	森严	从严治政	森严壁垒
宽大	宽	宽大为怀	宽宏大量	网开一面	不咎既往	既往不咎	手下留情	网开三面	宽松	宽限	从宽	从轻	不严
革命	红色	红	赤	辛亥革命	又红又专	代代红	新民主主义革命
反动	反革命	白色	白	逆
进步	先进	上进	红旗	进取	力争上游	不甘示弱	产业革命	学好
急进	激进
落后	后进	落伍	滞后
民主	群言堂
专制	独裁	专断	专权	擅权	武断	独断	一言堂	独断独行	一意孤行	一手遮天	孤行己见	大权独揽	不容置喙	生杀予夺	独断专行
讲理	通达	达	通情达理	明达	知情达理
蛮横	强横	霸道	跋扈	横暴	骄横	强暴	悍然	豪强	豪横	泼辣	无赖	暴	横	蛮	不近人情	不可理喻	不由分说	强词夺理	强横霸道	蛮不讲理	蛮横无理	横行霸道	横行无忌	称王称霸	专横跋扈	飞扬跋扈	肆无忌惮	横蛮	专横	蛮干	霸气
开通	开展	开明	通达	通情达理	知情达理
保守	守旧	封建	陈腐	迂腐	迂	穷酸	抱残守缺	墨守成规	因循守旧	陈陈相因	安于现状	固步自封	率由旧章	一仍旧贯	蹈常袭故	萧规曹随	步人后尘	等因奉此	闭关锁国	闭关自守	故步自封	墨守陈规	安于	半封建	寒酸	方巾气
公正	正义	公道	公	公平	持平	平允	公允	天公地道	不偏不倚	一视同仁	童叟无欺	老少无欺	公事公办	公正无私	爱憎分明	秉公	不徇私情
严明	明镜高悬	秦镜高悬	铁面无私	奖罚分明	嫉恶如仇
偏心	偏	一偏	偏颇	偏袒	左袒	左右袒	不公	不平	厚此薄彼	偏听偏信	吃独食	徇情枉法	劫富济贫	厚古薄今	吃偏饭	偏失
无私	大公无私	公而忘私	大义灭亲	舍身为国	廉正无私	舍己为公
克己奉公	枵腹从公	涓滴归公
舍己为人	舍己救人	见危授命	毫不利己
先人后己	吃苦在前	天下为公	忘我	无私	无私无畏	享乐在后
自私	私	自私自利	患得患失	损人利己	见利忘义	明哲保身	利己	损公肥私	化公为私	丢卒保车	独善其身
廉洁	清廉	廉正	廉明	廉	廉洁奉公	两袖清风	清风两袖	一尘不染	一身清白	水米无交	清正	廉政	道不拾遗	反腐倡廉	廉政勤政	清正廉洁	洁身自律	廉洁自律	肃贪倡廉
贪心	贪	贪婪	贪恋	贪欲	唯利是图	利令智昏	利欲熏心	馋涎欲滴	垂涎三尺	野心勃勃	贪得无厌	贪心不足	欲壑难填	得寸进尺	得陇望蜀	名缰利锁	权欲熏心	垂涎欲滴	贪婪无厌	贪大求全	贪求	不廉	淫心	物欲横流
见钱眼开	财迷心窍	爱财如命	虎视眈眈	见财起意
贪财	贪多	贪天之功
高尚	高贵	崇高	神圣	高风亮节	高雅	亮节高风	出尘脱俗	超凡脱俗	涅而不缁
正派	正经	正直	正当	正面	庄重	端正	纯正	方正	端庄	尊重	自重	自爱	目不斜视	俨	不俗	雅俗
庸俗	粗俗	鄙俗	俚俗	伧俗	俗气	俗	粗鄙	鄙俚	鄙吝	猥琐	委琐	世俗	无聊	百无聊赖	低俗	凡俗
下流	下作	下贱	猥贱	卑贱	卑鄙	卑劣	卑污	猥劣	猥鄙	龌龊	不端	不肖	不要脸	脏	秽	不三不四	见不得人	不堪入目	蝇营狗苟	媚俗
贞洁	贞烈	节烈	烈	贞	从一而终	纯洁性
纯洁	高洁	圣洁	天真	清白	一清二白	一尘不染	冰清玉洁	玉洁冰清	白璧无瑕	童贞	丰韵	清清白白
轻佻	轻薄	轻狂	浪漫	风骚	骚	妖艳	妖冶	妖媚	肉麻	癫狂	狎昵	嗲	嗲声嗲气	妖里妖气	搔首弄姿	油头粉面	有伤风化	性感	儇
淫荡	淫乱	荒淫	好色	猥亵	淫亵	淫秽	淫猥	浪	荒淫无耻	声色犬马	水性杨花	伤风败俗	荡检逾闲	淫糜
色情	香艳	艳情	艳	韵	桃色	黄色	风流	罗曼蒂克	贪色
多情	痴情	脉脉	脉脉含情	温情脉脉	儿女情长	多愁善感	柔情似水	一往情深
薄情	喜新厌旧
无情	负心	冷酷无情	无情无义	过河拆桥	鸟尽弓藏	得鱼忘筌	兔死狗烹	卸磨杀驴	忘恩负义	恩将仇报	以怨报德	铁石心肠	有理无情
太平	升平	承平	治世	清明	天下大治	天下太平	国泰民安	河清海晏	尧天舜日	莺歌燕舞	太平无事	平平静静	谧	歌舞升平
和平	相安无事	一方平安
安定	平安	稳定	安生	平静	安静	安宁	安谧	安澜	安乐	康乐	风平浪静	安居乐业	平服	稳定性	家弦户诵	祥和	政通人和	平稳	平安无事	长治久安	安定团结	宓	安外	安居	绥	泰
动荡	波动	不安	不定	乱	变乱	动乱	骚乱	多事	骚动	汹汹	摇摆不定	动荡不安	人心浮动	风雨飘摇	沧海横流	兵荒马乱	兵连祸结	狼烟四起	内忧外患	鸡犬不宁	天翻地覆	天下大乱	荒乱	捉摸不定	动荡不定	岌岌	忽左忽右	游走不定
混乱	纷乱	纷扰	扰乱	淆乱	乱腾	纷纷	乱糟糟	乱哄哄	心神不宁	人多嘴杂	困扰	狂乱	狂躁
繁荣	景气	发达	兴旺	旺	盛	兴盛	繁盛	昌盛	强盛	鼎盛	日隆旺盛	炽盛	全盛	兴隆	荣华	昌明	蓬勃	勃勃	沸腾	热火朝天	人欢马叫	万马奔腾	百废俱兴	欣欣向荣	繁荣昌盛	万古长青	根深叶茂	本固枝荣	如日中天	方兴未艾	蒸蒸日上	云蒸霞蔚	气象万千	百花齐放	满园春色	万紫千红	盛极一时	勃	勃然	昌	兴旺发达	树大根深	春色满园	红红火火	生机勃勃	万紫千红春满园	千花竞秀	生机蓬勃	生机盎然	兴邦	蓬勃向上	蓬蓬勃勃
萧条	冷淡	清淡	零落	百业待兴	低迷	百废待兴	走低
凋敝	凋零	衰落	没落	败落	破落	衰败	颓败	衰微	式微	衰颓	衰退	衰朽	阑珊	陵替	衰	淡	不景气	强弩之末	日暮途穷	日薄西山	桑榆暮景	大势已去	一落千丈	一蹶不振	每况愈下	千疮百孔	百孔千疮	气息奄奄	苟延残喘	再衰三竭	落花流水	萎靡	衰竭	稀落
天下兴亡	千古兴亡	盛衰	盛衰荣辱	兴衰	兴亡
热闹	繁华	红火	火暴	锣鼓喧天	敲锣打鼓	吹吹打打	载歌载舞	急管繁弦	隆重	热热闹闹	红极一时	酒绿灯红	热闹非凡
熙熙攘攘	熙来攘往	人来人往	门庭若市	履舄交错	车马盈门	车水马龙	万人空巷	人山人海	闻讯而来	熙攘
喧哗	闹	吵	闹腾	喧闹	喧腾	嘈杂	尘嚣	沸腾	鼎沸	哗然	哄然	喧嚷	鼓噪	吵闹	喧嚣	汹汹	烦嚣	聒耳	聒噪	嚷嚷	嚷	闹嚷嚷	闹哄哄	乱哄哄	闹翻天	七嘴八舌	沸沸扬扬	沸反盈天	轰然	哗	嬉闹	蜂拥而上	喧声四起
拥挤	挤	轧	蜂拥	挤挤插插	人山人海	水泄不通	磕头碰脑	前呼后拥	摩肩接踵	肩摩毂击	项背相望	冠盖相望	熙熙攘攘	熙来攘往	拥挤不堪	人多嘴杂	人头攒动	肩摩踵接	拥堵	拥簇	人满为患	塞车
安静	恬静	宁静	冷静	清静	沉静	寂静	肃静	僻静	幽静	清净	静穆	漠漠	寂寂	沉寂	冷寂	幽寂	清幽	幽深	寂然	岑寂	静谧	廓落	静	静悄悄	夜静更深	夜阑人静	夜深人静	鸦雀无声	哑然无声	悄然无声	悄无声息	万籁俱寂	静寂	谧静	幽篁	静静	幽僻	阒寂无声	静静的	默默无语
荒凉	荒僻	荒	地广人稀	人迹罕至	渺无人烟
凄凉	苍凉	凄苦	萧瑟	人去楼空	人亡物在	门庭冷落	清凄寂冷	凄厉	凄风冷雨
背	僻	冷僻	偏僻	荒僻	乡僻	僻远
冷落	冷清	冷清清	清冷	冷静	萧索	萧条	萧森	落寞	空荡荡	门可罗雀	无人问津	背静	冷冷清清	满目苍凉	寞	无声
孤单	孤	孤独	孤寂	伶仃	寥寥	寂寂	只身	一身	独身	光杆儿	孤零零	孤苦伶仃	伶仃孤苦	形影相吊	形单影只	孑然一身	孤家寡人	举目无亲	六亲无靠	无依无靠	单枪匹马	匹马单枪	离群索居	孤立无援	顾影自怜	单人独马	孤单单	孤儿寡母	孤僻	孤身	孤身一人	孤孤单单	形影相对	孤苦伶丁
寂寞	落寞	寂寥	岑寂	枯寂	寂寂	孤寂	寥落	寂	众叛亲离	与世隔绝
繁忙	忙	忙于	忙碌	碌碌	无暇	不暇	应接不暇	起早摸黑	日不暇给	披星戴月	席不暇暖	跑跑颠颠	四处奔波	疲于奔命	心力交瘁	日理万机	忙忙碌碌	东跑西颠	窘促	农忙	占线	大忙	缠身	没空	忙不迭	百忙之中
匆忙	匆促	急促	急忙	匆匆	仓促	仓卒	皇皇	造次	倥偬	行色匆匆	匆匆忙忙	匆猝	急匆匆	急急忙忙	急三火四	一路风尘
空闲	悠闲	幽闲	安闲	清闲	轻闲	闲暇	空暇	闲空	悠然	闲	空	逸	暇	空余	得空	有空	没事
赋闲	休闲	优游	闲适	闲散	恬淡	悠忽	悠悠忽忽	无所事事	优哉游哉	清风明月	轮空	穷极无聊	闲心	闲雅	野鹤闲云	悠然自得	赏月
舒服	舒坦	舒适	适	恬适	惬意	安适	适意	好过	甜美	写意	舒展	安逸	养尊处优	舒舒服服	趁心	如坐春风	过瘾	吃香的喝辣的
艰苦	艰辛	苦	辛苦	劳苦	辛劳	劳顿	劳瘁	劳碌	困苦	惨淡	千辛万苦	风尘仆仆	仆仆风尘	筚路蓝缕	餐风宿露	露宿风餐	风餐露宿	艰难竭蹶	饱经风霜	茹苦含辛	含辛茹苦	日晒雨淋	风吹雨打	栉风沐雨	艰苦卓绝	拖儿带女	辛辛苦苦	积劳成疾	坚苦卓绝	苦英英	累死累活	艰辛备尝	风吹雨淋	餐风宿雪	困难重重
安全	安好	安然	无恙	平安	安	安康	康宁	一路平安	安然无恙	高枕无忧	别来无恙	平平安安	安如泰山	有惊无险
治安	有警必接
危险	危	悬	危急	危亡	危殆	悬乎	险恶	凶险	惊险	艰危	不济事	险象环生	岌岌可危	千钧一发	一发千钧	不绝如缕	间不容发	厝火积薪	救火扬沸	危如累卵	摇摇欲坠	盲人瞎马	深入虎穴	朝不保夕	危在旦夕	生死攸关	生死存亡	鱼游釜中	如临深渊	如履薄冰	虎尾春冰	虎口拔牙	引狼入室	人人自危	饮鸩止渴	安危	危象	责任险	财险	奇险	危若累卵	高危	产险	惊险万状
大敌当前	腹背受敌	四面楚歌	危机四伏	弹尽粮绝	山穷水尽	自顾不暇	总危机	危及	危难	性命交关	经济危机	刀山剑林	风急浪大	大难临头
幸福	福	甜	甜蜜	美满	甜美	甜丝丝	洪福齐天	福如东海	人寿年丰	花好月圆	甜滋滋	甜甜的	甜蜜蜜
喜庆	喜	庆	大喜	吉庆	双喜临门
悲惨	凄惨	凄怆	悲凉	悲	凄凉	凄清	凄婉	惨痛	惨然	惨	惨不忍睹	伤心惨目	惨绝人寰	凄风楚雨	凄美	凄凄惨惨	无助	灾难性	哀婉
满目疮痍	疮痍满目	寸草不留	十室九空	血肉横飞	血流成河	腥风血雨	血雨腥风	赤地千里	家破人亡	妻离子散	生灵涂炭	鸡犬不留	民不聊生	饿殍遍野	水深火热	悲惨惨	家败人亡	命苦	目不忍睹	贫病交加	哀鸿遍野
离合悲欢	悲欢
和缓	缓和	舒缓	弛缓	松弛	轻松	弛懈	轻装	缓解	解乏
紧张	吃紧	白热化	剑拔弩张	刀光剑影	如临大敌	一触即发	千钧一发	一发千钧	箭在弦上	惊心动魄	密锣紧鼓	紧锣密鼓	磨刀霍霍	风声鹤唳	草木皆兵	山雨欲来风满楼	动魄惊心	紧紧张张	紧缺	逼人	刀光血影	焦虑不安	僧多粥少
庄严	庄重	整肃	严肃	肃穆	尊严	谨严	严正	威严	俨然	盛大	俨
清洁	干净	卫生	整洁	清爽	清新	洁	净	一尘不染	窗明几净	明窗净几	白净净	干干净净	洁净	净化	净空	清爽爽	无污染	清清爽爽
肮脏	龌龊	邋遢	污浊	污秽	恶浊	浑浊	脏	污	浊	秽	污染	脏乎乎	脏乱	滓	水污染	污迹	脏乱差	印迹
蓬头垢面	囚首垢面	衣冠不整
整齐	整	齐	整饬	齐整	严整	俨然	楚楚	齐楚	利落	划一	整齐划一	停停当当	浑然一色	衣冠楚楚	整整的
井然	井然不紊	井然有序	井井有条	有条不紊	有条有理	有板有眼	整整齐齐	秩序井然	齐刷刷	错落有致
杂乱	混乱	紊乱	纷乱	忙乱	淆乱	零乱	缭乱	错乱	乱杂	繁杂	冗杂	混杂	错杂	间杂	驳杂	拉杂	芜杂	庞杂	狼藉	杂沓	糊涂	横生	蓬乱	乱套	乱	烂	杂乱无章	杂七杂八	夹七夹八	乱七八糟	乌七八糟	纷纷扬扬	杯盘狼藉	背悔	眼花缭乱	拉拉杂杂	烂乎乎	撩乱	凌乱	不成方圆	紊	散乱	无规律
蓬松	枝蔓	纷	杂草丛生
一窝蜂	一锅粥	一团糟	一团乱麻	乱成一团	一塌糊涂
乱糟糟	乱腾腾	乱纷纷	乱蓬蓬	乱哄哄	七嘴八舌	七手八脚	打乱	藉	失调	污七八糟
富裕	富有	有钱	殷实	富贵	趁钱	富足	富庶	丰足	富饶	丰饶	穰穰	丰盈	丰裕	丰厚	厚实	优裕	余裕	宽裕	充盈	红火	富	宽	松	从容	方便	松动	活络	宽绰	有余	绰有余裕	绰绰有余	家给人足	丰衣足食	万贯家财	腰缠万贯	堆金积玉	金玉满堂	荣华富贵	财大气粗	富国	极富
小康	温饱	过得去	好过	次贫	饱暖
贫穷	贫	穷	贫困	穷困	清贫	贫乏	穷乏	空乏	贫寒	清寒	寒苦	寒微	穷苦	贫苦	赤贫	清苦	贫贱	竭蹶	身无分文	特困	一穷二白	家无担石	艰	老少边穷	鞠	致贫	返贫
困难	艰难	艰苦	困苦	拮据	不便	不方便	窘迫	困顿	倥偬	孤苦	紧	窘	紧巴巴	闹饥荒	清锅冷灶	穷山恶水	窘困	手头紧	真贫	千难万险	诸多不便
身无长物	别无长物	两手空空	囊空如洗	一贫如洗	一无所有	一文不名	不名一文	寅吃卯粮	缺衣少食	衣不蔽体	捉襟见肘	鹑衣百结	履穿踵决	糠菜半年粮	箪食瓢饮	并日而食	数米而炊	家徒四壁	债台高筑	饥寒交迫	贫病交迫	啼饥号寒	嗷嗷待哺	民穷财尽
打	击	揍	擂	动手	打私
毒打	痛打	夯	强击	猛打
敲打	打击	鼓	叩	击	敲	筛	擂	挝	鸣	敲敲打打	擂鼓	敲敲	敲门	敲击	叩门	叩开	叩响	叩击	戛
捶打	捶	捣	楔	钉	捣碎
砸	捣	敲响	敲开
拷打	拷	掠
抽打	鞭打	鞭笞	鞭挞	抽	鞭	笞
扑打	扑	踢打
磕打	摔打	磕	摔	掼	砸锅卖铁	砸烂	砸碎	打碎
打耳光	掌嘴	打嘴巴	耳刮子
还击	还手	回击	回手
拍	拊	扑	掸	拍拍
拍打	扑打
拍手	拍巴掌	鼓掌	拍掌	拊掌	击掌	拍击	缶掌	拍桌子
抚摩	摩挲	胡噜	捋	抚摸	爱抚
搔	抓	挠	抓挠	扒	抓痒	挠搔	挠头
摸	摸出	摸得着	摸摸	摩
拉	拉扯	扯	拽	掣	抻	挽	引	拉长	拉杆	拉开	直拉	拉纤	拉拉
推	排	揎	搡	排气	推杆	推开	推向
拖	拖曳	牵引	牵	引	挽	拉	拖床	拖住	拉住	趿
扛	荷	掮	夯
挑	担	挑水
抬	抬杠	扛	搭	舁	舆	抬扛	抬筐
背	驮	负	负重	背上
举	擎	扛	打	举起	挺举
托	把	托举	托起
高举	扬	揭	扬起
振臂	攘臂
举杯	把酒
捧	掬	端	端面	端平
揿	按	摁	按动	打伞
掐	扼	卡	捏
压	挤压	拶	按	扼住	压弯
压榨	榨	榨取
滚压	轧	磨	碾	擀	推	砘	风压	光压	静压	脉压	偏压	气压	渗透压	眼压	液压	油压
撑	支	抵	顶	戗	支撑	撑篙	撑住	硬撑
拿	持	执	捉	秉	操	仗	手	握	攥	搦	持有	持球	紧握	手持	执棒	握紧	持械	持枪	拿出	握有
把握	把	握住	在握	把住
抓	绰	捞	攫	抓差	抓起	力抓	捞取
提	拎	提起
出具	出示
撮	拈
揪	扭	掀开
夹	挟	夹馅	裹挟
搀	扶	搀扶	扶掖	扶持	扶老携幼	扶起	携手	勾肩搭背
挽	牵	携
抱	搂	揽	搂抱	拥抱	抱抱
合抱	合围
拔	擢	搴	薅	拔节	自拔	拔掉	拔出
摘	采	采摘	采撷	摘取	摘发	采采	摘掉
剥	扒	揭	剥离	剖开	扒开
撕	扯	撕开	撕破	撕碎	撕下	摘除	撕裂
抽	掣
折	撅	拗	折断	攀折	扭断	折中	掰开
掰	劈	擗
挖	剜	掘	刨	抠	凿	掏	扒	打	开	挖掘	开掘	发掘	开凿	挖潜	钻井	打通	打桩	掘进	掘开	开路	打井	开挖	挖沙
刳	掏空	洞开	挖出
剔	挑	撬	剔出
钳	夹	搛
填	堵	堵塞	塞	楦	回填	填平	塞入	装填	揣	装满	充填
埋	掩埋	埋藏	埋入
埋葬	葬	瘗	入土	崖葬	葬身	国葬
塞	掖	塞入
插	栽	簪	扦插	加塞儿	倒插	插队	插入	安插
嵌	镶	镶嵌	藉	嵌镶
衬	垫	衬里	垫脚
放	搁	置	撂	厝	坐	搭	安放	放置	停放	留置	置于	放到	放开	前置	内置	置放	放权	平放	嵌入	措
竖立	立	戳	竖起
下	投	投放	撂下	施放	排放	置之脑后
堆	垛	码	摞
叠	折	折叠	沁	佴	矗起
挂	吊	张	悬	悬挂	张挂	倒挂	高高挂起	钩挂
铺	摊	墁	铺摊	席地	铺开	铺平
盖	遮盖	覆盖	捂	瓦	苫	捂住	焘
掀	揭	撩	褰	掀起	擤	幂	撩开
捋	攘	揎
仍	掷	抛	掼	摔	投	甩	丢	拽	撇	投掷	抛掷	投射	扔掉	甩掉	空投	投标	投向	抛光	丢开	远投	竞投	投中	甩开	投球
接	承	承接	接球
拾	拾取	捡	撷拾	拣到	捡拾
松手	放手	撒手	失手
包	裹	包裹	包装	封装	打包	卷入	装进	裹进
装	盛	装入	装坛
卷	挽	窝	卷曲	卷起
捆	扎	缚	束	打	缯	襻	拢	绁	勒	箍	捆扎	包扎	捆绑	绑	牢系	绑扎	松绑
五花大绑	红绳系足	反转
栓	拴
扣	系	纽
打结	系	绾
绞	拧	上	绞手
绕	络
穿	穿着	着	服	衣	擐	上身	登	穿戴	穿上	穿衣	身穿	试穿
披挂	身披	披红戴花
戴	冠
佩带	佩	带	别	佩戴	身着	着装	安全带	配戴
脱	褪	扒	下	卸	宽衣	松开	卸下	卸掉
脱帽	免冠	脱皮	挣脱
解	松	褪	解开	肢解
拆	拆除	拆毁	拆卸	拆开	拆迁	拆散	拆线	拆解
涂	涂饰	涂抹	擦	上	敷	搽	抹	刷	抿	抹煞	外敷	涂刷
糊	刮	抹	泥
贴	粘	胶	糊	粘贴	胶合	粘合	贴边	贴补
裱	裱褙
洗	浣	涤	濯	澡	漱	湔	盥洗	清洗	洗涤	洗濯	涤荡	涤除	漱口	洗洁	洗洗	保洁
洗澡	沐浴	冲凉	浴	擦澡	淋洗	洗浴
搓澡	搓洗
刷洗	洗刷
冲洗	冲
荡	涮	漂
浆洗	浆	换洗	涮洗	洗煤	洗手	洗衣	漂洗	雪洗	淘洗
扫	扫除	打扫	除雪	扫雪
清扫	大扫除	洒扫	犁庭扫闾
擦	拭	揩	抹	抆	擀	拂	拂拭	擦	上浆	板擦儿	擦拭	抹掉	擦洗	擦屁股	拭泪	擦亮
磨	钢	鐾	砺	砣	研	擂	错	打磨	研磨	磨擦	磨刀	碾碎
揉	揉搓
捻	搓	捻子
捞	打捞	罱	捕捞	捞起
舀	打	挹	撇	掏
灌	注	灌溉	灌注	浇灌	倒灌	管灌	滴灌
汲	吸	戽	车	汲水
浇	淋	浇注
洒	泼	潲	撩	抛洒
沏	冲	泡	沏茶
斟	倒	筛	酾
筛	罗	淘	筛选
簸	扬	簸扬
滤	淋	漉	酾	过滤
搅拌	拌和	搅和	搅动	打	搅	拌	馇	洗
搀和	搀杂	搀	和	对
掭	膏	蘸
切	铡	刭	劐	芟	钐	镗
切片	片	切除	切开	切块
削	修	剡	绞	旋	锛	切削
割	拉	刈	剌
剖	破	划	锯	劈	劈开
剪	推	铰	裁	裁剪	剪裁	翦
修剪	修	修理	修枝	葺
刻	雕刻	雕	琢	契.
砍	斩	斫	剁	斫	伐	砍伐	采伐
乱砍滥伐	滥伐
伐树	伐木
刮	刮削	批	抢	剃	刨
戳	捅	通	扎	穿	杵
刺	搠	攮
戳穿	剌	穿刺	穿孔
碰	触	捅	动	触动	动手	触摸
翻	倾	倒	攉	翻腾	倒腾	掀翻	翻翻	倒入
倾倒	放
扇	鼓
撒	播	散	散步	播撒
开	打开	张开	启	被	展	敞	敞开	拉开	启封	翻开	开启
关	关闭	闭	合	掩	阖	密闭	虚掩	关掉	闭合	封关	闭锁
上锁	锁
搬动	挪动	移动	腾挪	移	搬	挪	移送
摇动	摇撼	撼动	摆动	晃动	摇	皇	摆	荡	舞狮	摇头	偏移	摇摇摆摆	摆摆	摇摇
扇动	振
抖动	抖搂	抖	甩	拂	擞
挥动	挥舞	舞动	舞弄	挥	舞	抡	晃	手摇	挥手
招手	招	摆手
拨动	扒拉	拨拉	拨	扒	拨开
扒	扒拉
扳动	扳	搂
摆弄	弄	调弄	拨弄	盘弄	搬弄	鼓捣	捣鼓
玩弄	戏弄	耍
揉	团
弹起	反弹
比画	比	比试	打手势	指手画脚	比划
指点	指画	指	点	指指戳戳
袖手	揣手儿	抄手
握手	拉手	抓手
走	行	步	履	跞	走动	走路	走道儿	行走	行动	行路	行进	步履	逯
拔腿	拔脚	举步	迈步	迈开
止步	却步	停步	站住	站住脚
步行	徒步	徒步走
阔步	纵步	大步	大步流星	齐步	齐步走
小步	碎步	蹀躞
快步	疾步	奔走	疾走	奔	趋	健步如飞	快步流星	三步并作两步
慢走	踱	徐步	缓步	彳亍	鹅行鸭步	慢行	姗
散步	溜达	遛	逛	绕弯儿	遛弯儿	转悠	转转	走走
漫步	信步	信马由缰	穿行	闲庭信步
闲逛	游逛	闲荡	游荡	荡	游	徜徉	逛逛	倘佯
蹒跚	踉跄	跄踉	趔趄	趑趄	跌跌撞撞	磕磕绊绊	磕磕撞撞	一溜歪斜	踉踉跄跄	跄	蹒
扭	折腰
徘徊	盘旋	低回	踯躅	蹀躞	回游	踱步
蹑	溜
登高	登	陟	爬
蹑手蹑脚	轻手轻脚
大摇大摆	高视阔步
踏遍	走遍
跑	驱	奔	奔跑	跑步	小跑	奔走	颠	弛	骋	跑动
狂奔	飞奔	飞跑	奔命	奔向
驰骋	驰驱	驰骤	跑马	奔腾	驰
飞驰	奔驰	疾驰	飞车走壁	骧
跳	跳跃	腾跃	踊跃	雀跃	鱼跃	跃进	跃	蹦	腾	蹿	纵	纵身	纵步	跃动	弹跳
连跑带跳	跑跑跳跳	撒欢儿	蹦蹦跳跳	虎跃龙腾
踢	踹	蹴	尥蹶子	踢蹬	踢打	蹬	蹬腿	蹬踏
踩	踏	登	践	蹴	踹	蹈	践踏	踏平	踏上
跺脚	跳脚	跺
踮	跷
抬脚	起脚
坐	坐坐	坐下
端坐	正襟危坐
席地而坐	后坐
盘腿	趺坐	跏趺
打坐	入定	坐禅	坐定	坐功
入座	落座	就座	就坐
蹲	踞	猴
立	站
伫立	伫
直立	兀立	挺立	鹄立	立正	立定	重足而立
站稳	站住	站队	站柜台	站立
起立	站起	谡
骑	跨	单骑	跨上	骑车
跨	迈	翻过	横跨	横亘	跨步	迈出	跨过
越	翻	翻越	腾越	翻翻
抬头	昂首	翘首	昂起	仰头
低头	垂头	俯首
回头	回首	掉头	转脸	扭头
点头	颔首	首肯	点点头
睁眼	张目	开眼	睁
瞪眼	瞪	瞠目
闭眼	合眼	闭目
眯眼	眯缝	眯	饧	觑
眨眼	眨巴	忽闪	闪动	眨
飞眼	使眼色	递眼色	挤眉弄眼
皱眉	皱眉头	蹙眉	颦	愁眉不展	皱眉
撅嘴	努嘴	撇嘴
接吻	亲吻	亲嘴	吻	亲
看	瞧	瞅	视	观	览	相	盼	顾	张	望	觑	目	睃	探望	观望	观看	收看	察看	见到	走着瞧	见状	见兔顾犬	来看	总的来看	看出	看到	看来	看齐	看样子	观展	观览	看看	见见	阚
注视	凝视	凝眸	凝望	瞩望	注目	瞩目	目送	定睛	逼视	盯	瞄	睽睽	目不转睛	只见	直盯盯	盯住
端详	端量	细看	审视	瞩	瞻	审美
展望	瞻望	遥望	远望	登高望远	望去	望望
了望	眺望	守望	远眺	凭眺	眺	极目眺望	极目远眺
环视	扫视	环顾	围观	扫描	举目四望
鸟瞰	俯瞰	俯视	尽收眼底
仰望	仰视	举目	瞻仰	仰天
张望	顾盼	东张西望	左顾右盼
回眸	回顾	反顾	回望	反观
极目	纵目	骋目	放眼	纵览	纵观	一览	一览无余	统观	概览
正视	目不斜视	令人注目	面对面
斜视	乜斜	侧目	瞟	眄
怒视	瞪	怒目而视	侧目而视
对视	目视	平视	相望	隔海相望
窥探	窥见	窥视	窥	偷眼	偷看	觇	探头探脑	窥测	窥伺	斑豹一窥	偷窥
瞥	扫	睨
白眼	白	乜
浏览	溜	采风	参观	览胜
看见	瞧见	望见	瞅见	瞥见	见	睹	触目	映入眼帘	尽收眼底	眼见	瞧瞧	细瞧
目睹	目击	目见	亲见	马首是瞻	略见一斑	观礼	观摩	观战	亲眼见	亲眼目睹	耳闻目见
望风	把风	观风	巡风
一窥全豹	一斑窥豹	以小见大
看起来	看上去
听	收听	听取	听听
倾听	聆听	聆取	聆	洗耳恭听	静听	谛听
偷听	窃听	属垣有耳	隔墙有耳
听见	闻	聪	视听	听到
听说	耳闻	传闻	风闻	闻讯	时有所闻	听讲	亲闻
嗅	闻	难闻
闻到	嗅到
吃	食	茹	餐	动	用	啖	服	偏	零吃	民以食为天	吃请	吃掉
摄食	吃光	饱餐
内服	口服
啄	塞	馕	填	狼吞虎咽	塞入
嚼	咀嚼	噍
咽	哙	吞	吞食	吞服	冲服	服药	服用	咽下	吞咽
吮	吸吮	吮吸	吸食	吸	嗍	嘬	裹	咂	吮吸	茹毛饮血	吸入
喝	饮	呷	啜	抿
喝酒	饮酒	喝
豪饮	狂饮	酣饮	畅饮	痛饮	饮水	饮用
酗酒	纵酒
饮茶	喝茶
叼	含	衔	噙
舔	舐
咬	噬	磕	啃	啮	咋	嗑	咬牙
叮	螫
呼	哈	呵	嘘	吹
送气	嘘气
吐	唾	啐
喷	喷气	喷吐	喷云吐雾
吸	抽	吧	吧嗒	吧唧	空吸	吸附	吸气	吸烟	抽烟
呼吸	透气	深呼吸	四呼	人工呼吸
做声	发音	失声	声张	嚷嚷	发声
呻吟	哼	打呼	哼哼
吧嗒	吧唧	咂嘴
呼唤	呼	唤	叫	招呼	传唤
吹口哨	打口哨	啸	呼哨	口哨
喊	呼	喝	嚎	嚷	喊叫	叫喊	呼喊	呐喊	叫嚷	吵嚷	喧嚷	呼号	叫号	喊话	叫唤	啧	疾呼
大叫	号叫	高喊	高呼	大喊大叫	大声疾呼	大喊	呼叫	人声鼎沸	惊呼	惊叫	喝六呼么	吼三喝四
吆喝	咋呼	叱喝	喝	呼幺喝六	当头棒喝	吆
吼	咆哮	怒吼
欢呼	喝彩	吹呼	满堂喝彩
喝倒彩	嘘	倒彩
哀鸣	哀号	悲鸣	嘶叫	四呼	吒	唳	嗷嗷叫	哀嚎	哀呼	哀叫	嚎啕
叫	鸣	啼	哨	噪	啭	打鸣儿	鸣叫	吠形吠声
吼叫	吼	啸	吟	嗥	嚎	啼	嘶	吠	咬	空喊	狂吠	狂呼	虎啸	长啸
飞	飞翔	翱翔	回翔	翥	展翅	翱	翔	翩	羿	颉
高举	飞腾
翻飞	翩翩
蠕动	蠕蠕	咕容	蠢动	蠕
倾	倾斜	歪斜	打斜	斜	歪	侧
靠	倚	凭	倚靠	挂靠
偎	偎依	依偎
躺	卧	睡	横躺竖卧
躺下	卧倒	躺倒
仰卧	平卧
静卧	安卧
趴	卧	扑	伏	俯伏	趴下
弯腰	哈腰	折腰	躬身
欠身	欠
伸腰	伸懒腰
蜷曲	蜷	弓	蜷缩	蜷伏
前仰后合	前俯后仰
打滑	滑	溜	出溜
跌倒	摔倒	栽倒	栽	绊倒
跌交	摔交	栽跟头	摔跟头	栽斤头	跤
仆	踣	狗吃屎
失脚	失足
打前失	马失前蹄
发抖	颤抖	战抖	抖	寒战	颤栗	哆嗦	筛糠	打哆嗦	战战兢兢	打冷颤	寒颤	寒噤	颤	打颤	战栗
颤悠悠	颤颤巍巍
打滚	翻滚
倒立	拿大顶
翻跟头	滚翻
跟头	斤斗
翻身	辗转	折腾	翻来覆去	辗转反侧	辗
爬	爬行	匍匐
蜿蜒	蛇行
爬山	登山	爬山越岭
攀	爬	攀登	登攀	攀缘	攀援
钻	钻进	潜入	扎
冲	闯	撞	扑	冲突	冲开
奔突	狼奔豕突	横冲直撞	猛扑	瞎闯	猛冲
挤	挤挤
行礼	敬礼	施礼	有礼	致敬
鞠躬	折腰	哈腰	唱喏	打躬作揖
裣衽	拜拜	万福	福
还礼	回礼
下跪	跪	屈膝	长跪	跪倒	跪下
磕头	叩头	叩首	跪拜	叩	拜	顿首	稽首	厥
膜拜	顶礼膜拜
高兴	开心	愉快	欢快	称快	快活	快乐	欢乐	欢娱	欢愉	欢欣	欢喜	喜欢	欣喜	欣然	怡然	陶然	愉悦	融融	乐意	乐	欢	喜	快	欣	怡	乐陶陶	乐滋滋	乐呵呵	乐悠悠	乐融融	喜冲冲	喜滋滋	喜洋洋	喜气洋洋	兴冲冲	甜丝丝	美丝丝	美滋滋	欢欣鼓舞	赏心悦目	如获至宝	僖	高高兴兴	逸乐	欣悦	悦	欣欣然	快快乐乐	欢欢喜喜	欢悦	喜悦	先睹为快	其乐融融	撒欢	暗喜	为之一喜	恺
狂喜	销魂	欢天喜地	欣喜若狂	喜出望外	大喜过望	兴高采烈	乐不可支	其乐无穷	心花怒放	不亦乐乎	得意洋洋	合不拢嘴	惊喜万分
开颜	喜形于色	眉飞色舞	春风满面	满面春风	喜上眉梢	欢颜	喜不自胜	喜笑颜开	欢眉喜眼	兴高彩烈
欢腾	欢跃	手舞足蹈	欢呼雀跃
欣幸	庆幸	幸喜	幸甚	庆	拍手称快	大快人心	皆大欢喜	喜从天降	额手称庆	和乐	可贺
悲喜交集	惊喜交集	又惊又喜	转悲为喜	惊喜	大悲大喜	悲喜	喜怒哀乐
悲伤	伤悲	伤心	伤感	熬心	难过	难受	悲	哀	哀伤	悲哀	悲戚	悲愁	哀愁	哀戚	悲怆	忧伤	凄然	凄怆	凄恻	凄惶	殷殷	不是味儿	如丧考妣	凄风楚雨	同悲	可悲	不好过
悲痛	哀痛	沉痛	痛	痛心	悲愤	痛切	悲切	断肠	肝肠寸断	黯然销魂	长歌当哭	椎心泣血	痛定思痛	人琴俱亡	不堪回首	五内俱裂	悲痛欲绝	痛不欲生	万箭穿心	欲哭无泪	悲恸	悲伤欲绝	悲壮	叫苦连天
痛苦	痛	苦痛	惨痛	伤痛	惨然	悲苦	心如刀割	黯然神伤	缠绵悱恻	切肤之痛	睹物伤情
辛酸	酸辛	心酸	酸溜溜	苦涩	寒心
凄惨	凄楚	凄切	凄凄惨惨
兔死狐悲	物伤其类
忧愁	发愁	犯愁	忧	愁	忧伤	悄然	忧思	忧心忡忡	忧心如焚	心事重重	愁眉不展	愁眉锁眼	愁肠百结	郁郁寡欢	悲天悯人	愁思	背包袱
忧虑	焦虑	虑	忧患	担忧	忧惧	堪忧	令人堪忧	令人担忧
忧闷	愁闷	愁苦	忧郁	抑郁	阴郁	郁结	忧愤	悒悒	怏怏	郁郁不乐	闷闷不乐	忽忽不乐	怏怏不乐	气闷	忧困	抑郁寡欢
过虑	杞人忧天	庸人自扰
烦闷	烦心	糟心	烦乱	烦躁	烦恼	烦扰	忧闷	沉闷	苦闷	郁闷	愁闷	憋闷	闷气	憋气	窝囊	不快	憋	堵	烦	闷	苦恼	抑郁	郁悒	沉郁	窝心	愤懑	烦杂	坐卧不安	懑	苦于	懊恼	闷闷地	心烦	心烦意躁	烦忧	窝火	闹心	愤闷
憋屈	委屈
愤怒	恼怒	含怒	气恼	气愤	义愤	激愤	愤激	愤慨	愤然	愤愤	悻悻	愠	恚	怒	气	恼	愤	怒冲冲	气冲冲	气乎乎	气鼓鼓	恼羞成怒	怒气冲冲	怒气攻心	气哼哼	懑	怒目横眉	忿	慨	气呼呼	愤闷	生闷气	一怒之下
惹气	怄气	赌气	负气	怄	惹恼	可气
动火	动肝火	恼火	冒火	光火	发火	上火	挂火	动怒	发怒	生气	动气	火	炸	撺	嗔	发毛	发狠	红脸	眼红	红眼	变色	作色	发作	发脾气	闹脾气	使性子	耍态度	怒形于色	疾言厉色	直眉瞪眼	横眉竖眼	七窍生烟	脸红脖子粗	拂袖而去	黑下脸	不悦	一气之下
震怒	盛怒	怒火中烧	火冒三丈	赫然而怒	怒不可遏	勃然大怒	大发雷霆	暴跳如雷	怒气冲天	令人发指	怒发冲冠	气冲牛斗	义愤填膺	悲愤填膺	天怒人怨	老羞成怒	怒目圆睁	捶胸顿足
泄恨	泄愤	出气	撒气	迁怒	泄私愤
息怒	消气	解气	解恨
得意	抖	美	飘飘然	怡然自得	扬扬得意	扬眉吐气	自鸣得意	春风得意	扬扬自得	自得其乐	沾沾自喜	自我欣赏	摇头晃脑	摇头摆尾	踌躇满志	得意忘形	顾盼自雄	吐气扬眉	志得意满
惆怅	怅惘	惘然	怅	忽忽	忽忽不乐	惘然若失	若有所失	怅然若失	迷惘	怅然
失意	向隅
灰心	丧气	泄气	泄劲	气短	气馁	自馁	凉	懊丧	沮丧	灰溜溜	心灰意懒	灰心丧气	垂头丧气	心如死灰	槁木死灰	万念俱灰	心灰意冷	蔫头耷脑	心寒	寒心
消沉	低沉	黯然	感伤
颓丧	颓废	颓败	颓靡	颓然	颓唐	委靡	累累	萎靡不振	颓	委靡不振
失望	大失所望
扫兴	败兴	杀风景	大煞风景	煞风景
计划	筹划	规划	擘画	筹算	筹	统筹	设计	宏图	计划性	企划
筹措	运筹	运筹帷幄	统揽全局
策划	谋划	计谋	图谋	谋划	图	企图	深谋远虑	策动	要图	异图	广谋从众
打算	算计	计算	盘算	准备	计较	试图	待	拟	计	打小算盘	意欲	刻划	精算	人有千算
满意	惬意	乐意	中意	合意	可意	遂意	如意	称意	遂心	称心	可心	顺心	对眼	称愿	好听	遂心如意	称心如意	如愿以偿	心满意足	正中下怀	差强人意	深孚众望	看中	令人满意
满足	知足	满	偿	知足常乐
舒畅	宽畅	酣畅	欢畅	畅快	痛快	清爽	爽快	松快	好受	好过	得劲	是味儿	舒服	舒适	舒心	快意	适意	痛快淋漓	心旷神怡	赏心悦目	扬眉吐气	痛痛快快	吐气扬眉	飘飘欲仙	如沐春风	如坐春风	如沐春雨
轻松	自在	优哉游哉	逍遥自在	清闲自在	自由自在	轻轻松松
畅	敞	酣	尽兴	开怀	骋怀	敞开
不满	遗憾	缺憾	不尽人意	深怀不满	一瓶子不满
不平	鸣不平	抱不平	忿忿不平	不平则鸣	鸣冤叫屈
心安	安心	安详	安然	安	慰	安慰	快慰	欣慰	宽慰	告慰	心安理得
自慰	聊以自慰	聊以解嘲	望梅止渴	画饼充饥
瞑目	九泉瞑目	含笑九泉
不安	紧张	乱	烦乱	浮动	打鼓	疚	食不甘味	心事重重	心烦意乱	心慌意乱	心乱如麻	方寸已乱	心神不定	若有所失	六神无主	神魂颠倒	魂不守舍	魂不附体	坐立不安	坐卧不宁	惶恐不安	惴惴不安	诚惶诚恐	七上八下	忐忑不安	如坐针毡	芒刺在背	惶惶不可终日	紧紧张张	令人不安	寝食难安	心神不安	寝食不安	惴惴	仄	忐忑
惭愧	羞愧	羞惭	愧怍	惭	愧	忝	耻	羞	恧	汗颜	愧赧	愧恨	问心有愧	自惭形秽	无地自容
难为情	不好意思	过意不去	不过意
抱歉	抱愧	负疚	内疚	愧疚	歉疚	歉	有愧	愧对
心虚	虚	亏心	做贼心虚	心中有鬼	昧心
无愧	不愧	硬气	对得起	对得住	理直气壮	心安理得	问心无愧	当之无愧	无愧于	不愧为
镇静	沉着	镇定	沉住气	行若无事	若无其事	措置裕如	处之泰然	泰然处之	泰然自若	谈笑自若	满不在乎	不动声色	面不改色	宠辱不惊	稳如泰山	镇定自若	熙和恬静	波澜不惊	守静	处变不惊	定神	毫不动摇	见惯不惊
从容	不慌不忙	从容不迫	好整以暇	不慌不乱	从从容容
心静	平静	安静	宁静	恬静	熨帖	坦然	安然	释然	恬然	平心静气	心平气和	安安静静	沉心静气	少安毋躁
安稳	落实	塌实	笃定
慌张	发慌	着慌	心慌	惊慌	惊惶	发毛	张皇	仓皇	惶遽	慌乱	慌	毛	慌手慌脚	手忙脚乱	心慌意乱	不知所措	张皇失措	手足无措	无所措手足	惊慌失措	失魂落魄	惊魂未定	心惊肉跳	自相惊扰	慌慌张张	慌里慌张	恐慌	无所适从	断线风筝	没着没落	多躁少静	遑	仓惶	大呼小叫	虚惊	受宠若惊	大题小做
着急	焦急	心急	发急	焦心	心焦	焦躁	焦灼	焦炙	着忙	慌忙	急忙	匆忙	要紧	急	急急巴巴	气急败坏	迫不及待	急如星火	心急如火	心急如焚	心急火燎	火烧火燎	心切	油煎火燎	急茬	干着急	急火火	急急	狗急跳墙
急切	迫切	亟	如饥如渴	饥不择食	急功近利	急于求成	归心似箭	急不可待	急不可耐	急于	亟待解决	情急
殷切	殷殷	恨铁不成钢	如饥似渴
决意	决心	决计	决定	立意	定弦	锐意	狠心	下狠心	铁心	发狠	立志	矢志	发誓	誓	咬紧牙关	痛下决心	厉害	了得
犹豫	犹疑	迟疑	踟蹰	踌躇	动摇	徘徊	趑趄	瞻顾	瞻前顾后	犹豫不决	踟蹰不前	趑趄不前	裹足不前	优柔寡断	狐疑不决	迟疑不决	沉吟不决	举棋不定	欲言又止	首鼠两端	犹犹豫豫	犹豫不前	踌躇不前	当断不断	游移	彷徨	支支吾吾
三心二意	见异思迁	朝三暮四	朝令夕改	朝秦暮楚
无奈	无可奈何	百般无奈	不得已	迫不得已	万不得已	没法	没奈何	有心无力	万般无奈	迫于	远水解不了近渴	可望而不可及
奈何	无奈何	奈
无法	没辙	没门儿	无计可施	束手无策	别无良策	一筹莫展	黔驴技穷	力不从心	力不胜任	举鼎绝膑	无能为力	心余力绌	心有余而力不足	独木难支	孤掌难鸣	望洋兴叹	爱莫能助	鞭长莫及	回天乏术	独木不成林	黔驴之技	无从	没门	没法儿	无力回天
山穷水尽	日暮途穷	束手待毙	坐以待毙	听天由命	死路一条	在劫难逃
被迫	逼上梁山
抓瞎	抓耳挠腮	无从下手
难堪	好看	尴尬	为难	碍难
警惕	警觉	戒	当心	小心	居安思危	安不忘危	常备不懈	警醒	不容忽视
麻痹	松懈	松弛	松散	涣散	疲塌	麻痹大意	麻木不仁	高枕无忧	高枕而卧	松驰	痹	一盘散沙
疏忽	大意	忽视	忽略	失神	疏失	失慎	不注意	不经意	不在意	大意失荆州	千虑一失	在所不计
专心	悉心	潜心	入神	凝神	一心一意	全心全意	专心一志	专心致志	心无二用	聚精会神	全神贯注	凝神专注	心驰神往	专一	一门心思	一心	全身心	直视
分心	心不在焉	心猿意马	魂不守舍
沉迷	着迷	入迷	痴迷	迷恋	入魔	着魔	沉湎	沉溺	热中	迷	痴	耽	眩	痴心妄想	神魂颠倒	鬼迷心窍	乐此不疲	乐而忘返	乐不思蜀
陶醉	心醉	沉醉	醉心	如痴如醉	如醉如痴	如醉如狂	颠狂	自我陶醉	迷住	痴心
迷惑	迷惑	疑惑	一叶障目	迷惑不解	纳闷	困惑	何去何从	难以名状	迷离
留恋	贪恋	眷恋	依恋	怀恋	恋	流连	依依	低回	依依不舍	恋恋不舍	安土重迁	留连忘返	依依恋恋	思恋	恋家	恋春
习惯	惯	习以为常	吃得来	习惯于
上瘾	成瘾	成癖	嗜痂成癖
吃不服	吃不来
醒悟	觉悟	省悟	憬悟	觉醒	清醒	醒	如梦初醒	大梦初醒	醍醐灌顶	恍然大悟	迷途知返	败子回头	如梦方醒	猛醒	幡然醒悟	顿悟	顿觉	感悟	摸门儿	醒来
懂事	记事儿	开窍	通窍	觉世
惊奇	奇怪	惊异	诧异	奇异	骇异	纳罕	希罕	咋舌	惊讶	惊诧	骇怪	怪	异	奇	诧	惊愕	愕然	骇然	大惊小怪	讶异	惊呆	惊叹	叹观止矣	好奇
害怕	惧怕	生怕	怕	生恐	畏怯	畏惧	恐惧	疑惧	恐怖	胆寒	忌惮	畏葸	惶惑	失色	咋舌	丧胆	惮	惧	畏	怖	亡魂丧胆	闻风丧胆	丧魂落魄	魂不附体	魂飞魄散	魄散魂飞	战战兢兢	惊心掉胆	毛骨悚然	提心吊胆	胆颤心惊	心惊胆颤	心惊肉跳	心胆俱裂	不寒而栗	噤若寒蝉	惊恐万状	大惊失色	面如土色	面无人色	视为畏途	望而生畏	望而却步	人心惶惶	担惊受怕	胆破心惊	胆战心惊	心惊胆战	悬心吊胆	令人心悸	悚	慑
忧惧	吓坏	怔	心惊	怵	屁滚尿流	只怕	惟恐	令人生畏
后怕	余悸	心有余悸	谈虎色变	三怕
惊恐	惶恐	惊骇	怔忪	惶惶	惊惶失措	惊恐万状	杯弓蛇影	风声鹤唳	草木皆兵	如临大敌	惶惶不可终日	不可终日	惊弓之鸟	惊惧	面无血色
受惊	吃惊	震惊	震	惊	大吃一惊	惶惶然
畏缩	畏忌	退避	发憷	缩头缩脑	畏首畏尾	退避三舍	畏缩不前	畏难	畏罪
怕生	认生	怕人
怯场	怯阵
敬畏	敬而远之
激动	冲动	兴奋	心潮澎湃	百感交集	激动人心	心潮难平	激动不已	心潮起伏	令人鼓舞	催人奋进	气盛	昂奋	扼腕
兴致勃勃	津津有味
感动	感	触	动容	感触	百感丛生	催人泪下	令人感动	动感情	动人心魄
触动	动心	触景生情	即景生情	见猎心喜
感激	纫	领情	感激涕零	谢天谢地	感同身受	感激不尽
感恩	感恩戴德	感恩图报	结草衔环	买账
想象	设想	想像
空想	玄想	悬想	幻想	白日做梦	胡思乱想	想入非非	痴心妄想	异想天开	臆想	奇想
思考	思量	忖量	思忖	思虑	思索	思维	思想	考虑	盘算	合计	寻味	揣摩	琢磨	虑	想	思	构思	沉思	寻思	动脑筋	想想	思谋	默想	酌量	逻辑思维	思辨	心想	沉凝
浮想联翩	心血来潮	思潮起伏	思潮澎湃	心潮澎湃	心潮翻腾	浮思翩翩	思绪万千
幽思	深思	三思	熟思	深思熟虑	前思后想	思前想后	思来想去	静思	静心思过	发人深思	若有所思	思来想去
冥想	凝思	苦思冥想	冥思苦索	搜肠刮肚	苦思	冥思苦想
尽心竭力	煞费苦心	绞尽脑汁	搜索枯肠	挖空心思	处心积虑	呕心沥血	费尽心机	穷竭心计
苦心	刻意	着意	加意
设法	想法	变法儿	打主意	拿主意	千方百计	想方设法	灵机一动	急中生智	想尽
随想	随感	有感于
悟出	想开	想到	思悟	体悟
斟酌	酌	参酌	揣摩	琢磨	衡量	掂量	酝酿	研究	酌定	酌情
着想	设想	考虑
存心	居心	怀抱	心怀	胸怀	怀	抱	负	安	含	饮	煞费心机
感到	感觉	觉得	感	觉	发	深感	痛感	感觉到	倍感	备感
发觉	发现
认为	以为	觉得	道	看	当	觉着
主张	主持	主	力主	看好	着眼于
坚持	执	坚持不懈	坚称	硬挺	咬牙
推测	揣测	忖度	揣度	推度	测度	推想	想来	想见	推理	推求	推断	推论	度	想	揆	揆度	以己度人	测算	审度	揣摸	由此可知
臆断	臆测	臆	臆想
因小见大	尝鼎一脔
估计	估量	打量	估摸	估	量	忖	忖量	忖度	度德量力	审时度势	估价	估算	估估	估斤算两
猜想	猜测	猜度	猜谜儿	捉摸	怀疑	猜测	蒙	猜	自忖	猜猜	竞猜
预料	逆料	意想	料想	预想	预期	料	谅	虞	意料
料到	料及	承望	试想
预测	预计	展望	前瞻	预后
希望	企望	盼望	祈望	祈望	期望	巴望	指望	仰望	想望	瞩望	期待	梦想	愿意	企盼	希	望	盼	期	祈	企	巴	欲	要	祷	想	幸	冀	可望	冀望	但愿	意在	只求	务期
渴望	热望	切盼	翘企	眼巴巴	巴不得	企足而待	望眼欲穿	望穿秋水	梦寐以求	霓	望子成龙	恨铁不成钢	翘首以待	渴盼	亟盼	期盼	望子成才	求知若渴	嗜书如渴	求贤若渴	急待	大旱望云霓	恨不得	求之不得
向往	神往	憧憬
祈求	企求	希冀	希图	觊觎	贪图	图	眼热	热中
要求	渴求	务求	求	讲求
求得	邀
求全	苛求	求全责备
追求	探求	追逐	求	贪	干	射	力求	孜孜追求	奔头
谋求	谋	营	寻求
回忆	追忆	忆	回首	回顾	后顾	回溯	回想	追想	缅想	忆苦思甜	重温旧梦	想起	抚今追昔	追思	遥想	溯	温故知新	忆起
怀念	思念	想念	惦念	惦记	眷念	纪念	叨念	感念	顾念	感怀	怀想	思慕	思量	怀恋	眷恋	怀念	想	思	相思	朝思暮想	触景伤情
深思	渴念	寤寐思之	一日三秋
思乡	乡思	故土难移
念旧	怀旧	怀古	忆旧	恋旧
悼念	追悼	哀悼	悲悼	伤逝	悼	哀	挽	人亡物在	睹物思人	人琴俱亡	痛悼	凭吊	缅怀	志哀	忧念
挂念	悬念	系念	挂虑	挂心	记挂	牵挂	挂牵	挂怀	惦	挂	牵肠挂肚	惦挂	魂牵梦系	魂牵梦萦	挂记
记得	记	记忆	饮水思源
记住	记取	切记	牢记	铭记	言犹在耳	记忆犹新	念念不忘	永志不忘	没齿不忘	念兹在兹	刻骨铭心	铭心刻骨	铭肌镂骨	刻肌刻骨	铭刻	难忘	难以忘怀	铭记在心	耿耿不忘	纪事	挥之不去	耿耿于怀	魂牵梦绕
介意	在心	在意
忘记	忘掉	忘却	忘怀	遗忘	忘	置于脑后	淡忘	数典忘祖	忘本	记不清	丢三忘四
了解	理解	懂得	知道	晓得	明白	了了	领略	领悟	清楚	了然	明了	明亮	解	懂	晓	知	详	喻	明	亮	知情	知底	接头	敞亮	透亮	亮堂	分晓	掌握	知晓	未卜先知	冷暖自知，心明如镜	时有所闻	宽解	略知一二	察察为明	辩明
有底	有数	心中有数	胸中有数	胸有成竹	成竹在胸
看透	看穿	看清	洞察	洞悉	了如指掌	一目了然	洞烛其奸	知己知彼	明察秋毫	吃透	窥破	侦破
觉察	察觉	发觉	发现	窥见	意识
知悉	悉
明知	明理	深明大义
探悉	获悉	获知	得知	摸清	意识到	识破	查出	查获	深知	得悉	惊悉
熟悉	熟稔	稔知	熟谙	熟识	习	驾轻就熟	轻车熟路	如数家珍	知根知底	稔熟	耳熟能详	深谙	知彼知己
贯通	精通	通晓	洞晓	晓畅	通	谙	贯	会	融会贯通	相通	一通百通
顿开茅塞	茅塞顿开	豁然开朗
路人皆知	人所共知	鲜为人知
懂法	知法
认识	认得	认	识
相识	相知	谋面
体会	体味	吟味	回味	咀嚼	认知
领会	理会	意会	领悟	会心	会意	心领	悟	心领神会	心照不宣
不解	不详	茫然	发蒙	不清楚	不摸头	没谱儿	心中无数	一无所知	不甚了了	不得要领	雾里看花	大惑不解	茫然不解	未知	天知道	不知所终	不为人知	浑然不知	琢磨不透	茫然无措	茫茫然	不明不白
一知半解	似懂非懂	知之甚少
误会	误解
喜欢	喜爱	喜好	欢喜	爱慕	爱好	欣赏	希罕	好	爱	喜	嗜	耽	爱不释手	喜性
爱	喜爱	怜爱	心爱	钟爱	友爱	热爱	疼爱	酷爱	疼	慈	爱慕	老牛舐犊	挚爱	热衷	爱护
恋	爱恋	热恋	恋爱	恋情
溺爱	偏爱	宠爱	宠幸	宠	幸	娇	娇惯	惯	宠坏	偏好
倾心	动情	钟情	怀春	一往情深	一见钟情	为之动容	情有独钟	一见倾心	爱上	看上	忠于
相好	相爱	两小无猜
敬业爱岗	敬业
爱民如子	爱国	爱民	爱教
讨厌	厌恶	嫌恶	憎恶	痛恶	恶	厌	憎	嫌	烦	厌烦	腻烦	腻味	腻	头痛	作呕	倒胃口	深恶痛绝	疾首蹙额	掩鼻而过	看不顺眼	看不惯
嫌弃	厌弃
厌倦	倦
厌世	厌战
恨	怨	怨恨	怨艾	恼恨	恨死
仇视	仇恨	憎恨	憎恶	疾	交恶	反目成仇	狭路相逢	反目为仇	嫉恨	忌恨	结仇	会厌	夙嫌	亲痛仇快
怀恨	记恨	抱恨	抱恨终天	记仇
愤恨	痛恨	切齿痛恨	咬牙切齿	恨之入骨	恨入骨髓	痛心疾首	疾恶如仇	同仇敌忾	不共戴天	愤世嫉俗	敌忾同仇
责怪	怪罪	见怪	嗔怪	嗔	怪
埋怨	抱怨	怨声载道	民怨沸腾	天怒人怨	埋三怨四	怨天尤人	叫苦不迭
自咎	引咎	引咎自责
抱屈	抱委屈	闹情绪	委屈	错怪
尊敬	崇敬	敬重	敬爱	尊崇	尊	敬	礼贤下士	起敬	悌	敬意
敬仰	景仰	宗仰	仰慕	敬慕	景慕	慕名	心仪	想望	向往	仰
崇尚	崇	尚	奉若神明	敬若神明
相敬如宾	举案齐眉
令人钦佩	可敬	可亲可敬
尊师	尊老爱幼
佩服	敬佩	钦佩	赞佩	佩	畏	崇拜	悦服	叹服	倾	倾倒	肃然起敬	心悦诚服	五体投地	令人叹服
信服	服气	心服	折服	服	认	伏	买帐	心服口服	口服心服
认输	服输	甘拜下风
不服	要强
羡慕	慕	爱慕	欣羡	艳羡	称羡	叹羡	眼馋	眼热	眼红	红眼	令人羡慕	惊羡	羡	钦羡
妒忌	忌妒	嫉妒	吃醋	嫉	妒	酸溜溜	争风吃醋	妒贤嫉能	嫉贤妒能	妒嫉
相信	凭信	置信	信	令人信服	信得过	谌
确信	坚信	无庸置疑	确乎不拔	可操左券	坚信不疑	毫无疑义
轻信	听信	见风是雨	贵耳贱目	偏信
当真	认真	信以为真
自信	满怀信心	志在必得
信仰	信奉	崇奉	笃信	迷信	皈依	奉	信	皈	信教	归依
怀疑	狐疑	嫌疑	生疑	起疑	猜疑	疑心	疑虑	猜忌	多心	多疑	嘀咕	打结	疑	疑神疑鬼	疑心生暗鬼	存疑	信不过	犯嘀咕	难以置信
将信将疑	半信半疑
信任	相信	宠信	信赖	信从	亲信	言听计从	用人不疑	深信不疑	深信
赞成	赞同	同情	倾向	支持	众口一辞
同意	认可	可以	首肯	可	认同感	也好	可不	仝
拥护	拥	拥戴	爱戴	深得民心	民心所向	匡扶
拥军	拥军优属	双拥
反对	不敢苟同	不以为然	不依	唱反调	唱对台戏	不予
忍耐	忍	耐	忍受	容忍	隐忍	饮恨	忍气吞声	逆来顺受	含垢忍辱	忍耐力	控制力	耐受
克制	抑制	控制	自制	自持	抑止	压抑	按压	按捺	按	捺	压	平	憋	止	克	克服	相生相克	相依相克
约束	收束	收	律己	自控
禁不住	撑不住	忍不住	不禁	不由得	不禁不由	身不由己	不由自主	情不自禁	经不住	难以忍受	按捺不住
可惜	惋惜	痛惜	叹惜	叹惋	心疼	可叹
舍得	不惜	在所不惜	紧追不舍
爱惜	珍惜	体惜	爱	惜	敝帚自珍	珍爱	寸土不让	惜力
吝惜	吝	不舍	舍不得	难割难舍	难舍难离
怜悯	可怜	同情	悯	怜	惜	哀怜	爱怜	怜恤	体恤	哀矜	怜惜	怜贫惜老	不忍	怜香惜玉	悲悯	同病相怜
忍心	忍	于心何忍
体谅	谅解	谅	原宥
推己及人	将心比心	设身处地
原谅	见谅	担待	包涵	海涵	涵容	包容	宽容	优容	谅解	容	原	略迹原情
宽恕	宽饶	饶恕	恕	饶	饶命	超生	开恩	留情	容情	宽容	姑息	高抬贵手	手下留情	宽以待人
关怀	关心	关切	关注	眷顾	体贴	知疼着热	体贴入微	关怀备至	关爱
管闲事	多管闲事
担心	操心	揪心	顾虑	想不开	放心不下	揪人心肺	顾虑重重	操神	忧念
放心	想得开	如释重负	释怀	宽解
注意	留意	经意	在意	小心	留心	在心	经心	上心	留神	理会	瞩目	注目	专注	检点	顾	放在心上	只顾	眭	令人瞩目
权衡	衡量	权
计较	斤斤计较	锱铢必较	论斤计两
重视	珍视	珍惜	尊重	看重	倚重	器重	注重	推崇	赏识	青睐	垂青	讲究	重	器	厚	看得起	瞧得起	另眼看待	另眼相看	刮目相看	刮目相待	敝帚自珍	敝帚千金	侧重	强调	偏重	垂爱	仰观	讲求
保重	珍重
并重	并列	一视同仁	等量齐观	相提并论	一概而论	并排	并称
漠视	无视	冷淡	无所谓	不在乎	满不在乎	安之若素	一笑置之	付之一笑	掉以轻心	等闲视之	漠然置之	漠不关心
鄙视	蔑视	藐视	轻视	小视	小看	看轻	鄙薄	鄙夷	鄙弃	唾弃	轻蔑	侮蔑	不齿	菲薄	藐	薄	轻	看不起	瞧不起	不屑一顾	嗤之以鼻	文人相轻	小觑	轻敌	贬抑
置之不理	恝置	置之不顾	悍然不顾	撒手不管	置之度外	置若罔闻	置身事外	视若无睹	熟视无睹	恬不为怪	视而不见	充耳不闻	听而不闻	漠不关心	闭目塞听	不闻不问	秋风过耳	无动于衷	坐视不管
不置可否	听其自然	任其自流	无可无不可
闲置	弃置	搁置	废置	压	按	搁	撂	束之高阁	置诸高阁	不了了之
丢手	甩手	脱身	撇开
观望	旁观	坐视	坐视不救	袖手旁观	冷眼旁观	作壁上观	隔岸观火	坐观成败	坐山观虎斗
顾及	照顾	顾全	顾惜	兼顾	顾得上	观照
顾不上	顾不得
理睬	理会	答理	理	睬	问津
后悔	懊悔	追悔	忏悔	悔恨	悔	自怨自艾	吃后悔药	悔不当初	抱恨终身	痛悔	背悔
悔改	改悔	悔过	悔罪	悔悟	翻然悔悟	悔过自新	今是昨非
后悔莫及	悔之晚矣	噬脐莫及	一失足成千古恨	追悔莫及	后悔不迭
翻悔	反悔	反顾	悔棋
反省	内省	自省	省察	自问	扪心自问	反躬自问	抚躬自问	内视反听	闭门思过	反思	反躬自省	扪心自省
无悔	无悔无怨	无怨无悔
愿意	情愿	甘愿	甘心	甘于	乐意	乐于	肯	愿	甘心情愿	心甘情愿	何乐不为	甘当	肯切	何乐而不为
自愿	志愿	自觉自愿	乐得	两相情愿	自觉	愿者上钩
不甘	不甘心	不愿	死不瞑目	不甘落后
无意	无心	懒得	一相情愿	无意间
敢	敢于	胆敢	竟敢
能够	能	会	克	力所能及	可知	亦可
善于	长于	擅长	擅	善	工	娴	健	拿手	善用	能征惯战
不能	不许	使不得	办不到	决不能	力所不及	得不到	未能	无从
决不会	不会
可以	得以	足以	得	堪	好	可	足	有何不可	何尝不可	方可
不可	不得	不行	不兴	不足
能否	可不可以	可否	是否
应该	应当	该当	理当	理应	理合	该	应	当	合宜	相应	本当	本该	理所应当	应有	活该	有道是
必须	务须	务必	须要	须	务	要	得	必	必得	非得	总得	不能不	不可不	亟须
无须	毋庸	不必	不用	无庸	不要	不须	无需
何须	何必	何苦
值得	犯得着	犯得上
不值	不足	不屑	不犯	犯不着	犯不上
革命	变革	打天下	打江山
起义	首义
暴动	起事	举事	发难	造反	反	官逼民反	犯上作乱	揭竿而起	闹革命	夺权
锄奸	除暴安良	为民除害
推翻	打倒	推倒	打翻	击倒	赶下台
解放	翻身
斗争	争斗	战斗	决斗	抗暴	角逐	争雄	争夺	逐鹿	斗	龙争虎斗	鹿死谁手	搏击	抗争	武斗	战天斗地	征战	争霸	勇斗
斗法	钩心斗角	明争暗斗	斗心眼	勾心斗角
内乱	内讧	兄弟阋墙	煮豆燃萁	同室操戈	祸起萧墙	窝里斗
百花争艳	争奇斗艳
抗议	反抗	对抗
上台	登台	组阁	粉墨登场	登场	袍笏登场	当家做主	初掌帅印
即位	登基	黄袍加身	加冕
继位	承袭	禅让
称帝	称孤道寡	南面	称王
当家做主	当家	当家作主
统治	秉国	执政	当政	当道	当权	在位	拿权	掌权	掌印	用事	当家	主政
称霸	独霸	称王称霸
称雄	割据	封建割据
下台	下野	倒台	倒阁	在野
退位	让位	逊位
改革	改造	改制	革新	除旧布新	革故鼎新	兴利除弊	激浊扬清	涤瑕荡秽
变法	维新	改良	变法维新
救国	救亡	赴难	救亡图存	存亡	断绝	毁家纾难	救国救民
闭关自守	闭关锁国	闭关
镇压	弹压	高压	压服	压	超高压	镇住
镇反	肃反	剿除	清剿
讨伐	征伐	征讨	征	兴师问罪	吊民伐罪
平叛	平定	平息	敉平	扫平	扫荡	围剿	绥靖	靖	剿	平
篡夺	攘夺	夺取	篡
篡位	问鼎	窃国
颠覆	倾覆
复辟	变天	翻天	倒算	翻天覆地	颠覆
叛变	反叛	叛离	叛	叛乱	叛逆	背叛	反水	倒戈	哗变	反	策反	谋反	牾
叛卖	出卖	卖	吃里爬外
通敌	私通	里通外国	叛国	卖国
投敌	卖身投靠	认贼作父	卖国求荣
招兵	征兵	募兵	招兵买马	征丁
抽丁	抽壮丁
装备	配备	武装	武备	装设
备战	秣马厉兵	厉兵秣马	披坚执锐	枕戈待旦	严阵以待	摩拳擦掌	磨刀霍霍	磨拳擦掌
誓师	动员
检阅	阅兵
作战	打仗	战斗	交战	交火	交锋	交兵	杀	战	征	征战	上阵
接火	接触	交火	短兵相接	兵戎相见	兵戈相见	赤膊上阵
开战	开仗	开火	动武	用武	动干戈	宣战
挑战	求战
应战	应敌	迎战	迎头痛击	后发制人	出战
奋战	血战	浴血奋战	孤军奋战	孤军作战
激战	酣战	苦战	鏖战	鏖兵	打硬仗	恶战
决战	决一死战	一决雌雄	背水一战	背城借一
会战	大会战
转战	南征北战	纵横驰骋
起兵	动兵	用兵	出兵	出师	出动	兴师	进兵	进军	出征
同室操戈	火并	内乱	内讧
混战	群雄逐鹿	干戈四起	干戈扰攘
游击	打游击
好战	穷兵黩武
登岸	上岸
急行军	强行军
督战	督军
进攻	攻击	出击	进击	攻打	强攻	攻	击	伐	扑	抢攻
围攻	围击
夹攻	夹击	合击	分进合击	内外夹攻
冲击	冲锋	冲锋陷阵	厮杀	冲刺	拼杀
追击	穷追猛打	乘胜追击
抵抗	抵御	抗御	抵挡	反抗	对抗	招架	拒	抵	抗	敌	御	迎击	抗击	抗拒	顽抗	负隅顽抗	阻抗
招架不住	不可抗力
回击	还击	反击	反攻	反扑	杀回马枪	反戈一击
保卫	捍卫	护卫	卫护	侍卫	捍	保	卫
防守	防御	捍御	防卫	守	把守	看守	扼守	镇守	守卫	守护	监守	戍守	戍
布防	设防
调防	换防
戍边	边防
警卫	警备	戒备	卫戍
驻扎	屯扎	驻屯	驻守	驻防	进驻	驻	屯	留驻	屯兵
扎营	宿营	安营扎寨
站岗	放哨	执勤
巡逻	巡查	巡视	巡	哨	巡	巡行	巡回	徇
射击	发射	开	发	放	打	打靶
开枪	打枪	枪击	鸣枪
开炮	放炮	打炮	炮击	轰击	炮轰
还击	回击
空袭	轰炸	投弹	狂轰滥炸
爆破	炸
刺杀	拼刺刀	肉搏	拼刺
扫雷	排雷	探雷
埋伏	打埋伏	设伏	伏击
袭击	侵袭	袭取	掩杀
闪击	突击	欲擒故纵
邀击	拦击	狙击	阻击	截击
抄袭	兜抄	包抄	迂回	抄
偷营	偷袭	突袭	掩袭	乘其不备
引敌他顾	调虎离山
接应	策应	里应外合	内应
掩护	打掩护	断后
牵制	牵	犄角
侦察	侦探	斥	刑侦	侦
包围	围困	合围	围城	困	围城打援	围魏救赵	围住
突围	杀出重围	冲破	打破
侵略	侵犯	进犯	窜犯	侵入	侵越	侵扰	入侵	入寇	犯	寇	侵	进袭
并吞	吞并	侵吞	兼并	侵占	吞灭	吞噬	蚕食	鲸吞	蚕食鲸吞
骚扰	扰乱	扰	袭扰	喧扰	肆扰	窜扰
攻占	抢占	攻克	夺取	袭取	攻破	攻陷	打下	下	破	克	拿下	占领	攻城略地	攻城掠地	一锅端	攻取	把下	夺回
占据	占	盘踞	龙盘虎踞
收复	克复	光复	取回
击败	打败	战败	挫败	击破	击溃	粉碎	重创	败	破	克敌制胜	各个击破	制伏
击退	退	却
歼灭	剿灭	歼击	消灭	解决	吃	歼	横扫千军	攻歼	全歼	歼敌
围歼	聚歼	围剿
摧毁	击毁	夷
撤兵	收兵	退兵	退却	撤退	撤防	撤	班师	回师	鸣金收兵	撤走	后撤	撤军	撤出
俘虏	生擒	生俘	活捉	擒拿	俘获	俘	虏	执	擒	获	捉	擒敌	扭获
缴获	收获	截获	缴	缴械	缴枪	收缴	虏获
投降	归降	降服	降顺	降	投诚	反正	缴械	解缴
请降	乞降
佯降	诈降
割地	割让
归顺	归附	归心	俯首称臣
招安	招抚	招降
大败	溃
治理	经纬	经纶	御	治	听	治治	纬	治监
治世	治国	治国安民	安邦定国	励精图治	经纶天下	治国安邦	齐家治国平天下	施政
办理	办	做	作	干	操办
经办	承办	经手	过手
包办	一手包办	包办代替
代办	代理	署理	摄	代劳	代庖	越俎代庖
筹办	筹划	筹
处理	料理	操持	处置	处事	安排	措置	处分	从事	裁处
清理	踢蹬	理清	分理
密封	封
管理	经营	掌管	治理	管事	掌	管	理	问	管管	治治	管治
保管	管理	管制	管住	田间管理	治本	军事管制
综合治理	综治
经营	经纪	经理	经	营
国营	国立	公营	公立	公办	官办	国办
私营	私立	民办
苦心经营	惨淡经营
营业	运营
主营	专营
自主经营	自营
安置	安顿	安排	铺排	交待
部署	布局	布置	配置	配备	布	安排
调动	调	调整
调剂	调节	调试
调拨	划拨	拨	划	划转	核拨
调遣	调派	调配	选调	调兵遣将
整顿	整饬	整治	整肃	整	饬	整改
整编	改编	收编
派遣	指派	选派	特派	打发	差使	差遣	派	遣	使	差	着	叫	外派	派出
分派	分发	分配	分
支使	支派	使唤	支
指名	点名	指定
建立	成立	树立	确立	建	立	起	树	植	起家	白手起家	另起炉灶
立国	开国	建国
建都	奠都	定都
立宪	立法
立户	立业	成家立业	建业	建功立业	置业
架起	搭设
合办	协办
设立	设置	开设	开办	设	开	办	举办	兴办	立	办起
开辟	辟	开拓	打开
创立	开创	创始	创建	创办	创造	缔造	创设	创	始建	创导	开立
初创	草创
首创	创始	始创
独创	自我作古	独辟蹊径	标新立异	独树一帜
创出	创下
命名	定名	起名儿	取名	为名
撤销	取消	注销	吊销	勾销	缴销	销	撤回	收回	撤除	裁撤	撤	撤消
废止	废除	废黜
免除	罢免	豁免	免去	解除	罢	免	蠲	免予	免掉
解散	遣散
一风吹	一笔勾销	一笔抹杀
收	接收	收执	收取	收受	收纳	接受	接纳	接	吸纳	吸收	收到	收下	收起	接下	接到	接过
发	颁发	发出	下	行文	下发
发放	发给	关
散发	分发
颁证	发证
请假	告假	续假
主持	主管	掌管	主办	拿事	司	秉	牵头
指挥	挥	麾
统率	统领	领队	带队	带领	率领	提挈	率	引领
执掌	掌握	掌	握	拿	柄
管辖	统辖	统摄	统御	总统	总理	节制	统制	辖	部	统	管
控制	统制	宰制	主宰	支配	操纵	摆布	掌握	左右	牵线	驾御	控	控管
把持	垄断	占据	独占	收揽	总揽	独揽	揽	专	霸	据	把	占
召集	招集	集合
宣布	发布	公布	颁布	发表	宣告	通告	昭示	颁发	揭晓	揭示	披露	颁	公布于众
发榜	出榜	张榜	揭榜
下令	命令	指令	通令	传令	授命	命	令	饬	发号施令	三令五申	发令	吩咐	一声令下	限令
责令	责成
勒令	强令	喝令
令行禁止	言出法随
宣传	宣扬	阐扬	揄扬	扬	鼓吹	造舆论	做广告	大吹大擂	大喊大叫
发动	鼓动	掀动	动员	总动员	兴师动众	劳师动众	掀腾
提倡	倡议	首倡	倡导	发起	倡
号召	召唤	呼唤	唤起	召	振臂一呼	感召
唤回	召回
响应	应	一呼百应
呼叫	呼唤
建议	提议	纳谏	建言献计
讨论	议论	议事	座谈	审议	商议	探讨	研讨
决定	定规	裁夺	裁决	裁断	裁定	核定	议定	议决	表决	定夺	公断	公决	仲裁	决策
定局	拍板	定	决断	处决	定案	断	商定
规定	确定
肯定	确认	认可	认定
否定	否决	推翻
制订	制定	创制
拟订	拟定	草拟	拟	拟就
登记	注册	报	挂号	报了名
签到	报到	记名	登录
报失	挂失
申请	报名	提请
报考	投考
报告	汇报	上告	上报	呈报	层报	申报	禀报	反映	举报	反馈
交差	交卷	交代
虚报	浮报	伪报
回报	回话	回禀	复命
上书	奏
签字	签名	具名	署名	签署	签	署	签定	签约
画押	签押	押尾
盖章	打印	加盖
批阅	圈阅
批示	批复	批
签注	签证	签
批准	照准	准予	准许	许可	认可	特许	准	获准	特批	开绿灯	恩准
禁止	取缔	查禁	禁	禁绝	不准	明令禁止	严令禁止	来不得
禁而不止	屡禁不止	屡禁不绝
解禁	弛禁
调查	考察	查明	踏看	踏勘	踏看	查	查证	检察	调研
侦查	侦探	侦缉	查访	察访	内查外调	明查暗访	微服私访	明察暗访	暗访	探查	探明
察明	查清
审查	审察	审核	复核	查对	核对	审	对	按	甄别	甄	核	查处	审结	稽核	核试	稽审	核查	查核	审干
审定	核准	把关	审验	核实	检定
过目	寓目
自审	自查	自纠自查
初查	收审
检查	稽查	稽考	考查	查看	查	稽	视察	查究	查验	查考	检验	检视	验	点验	验证	印证	查实	检	查检	查查	稽察	检察
盘查	盘问	查问	查询	盘根究底	严查
联检	联查
监督	督察	监察	督	督查	监察	监控	监理
监视	监	蹲点
监考	监场
督促	钉
查点	清点	检点	过数	点	盘	清	盘账	清账
点名	点卯	唱名
评议	评判	评比	评定	鉴定	裁判	评	判	论	考评	贬褒
评论	评说	评价	讲评	品评	臧否	褒贬	品	评	评头品足	评头论足	品头论足	评介
考核	考绩	考勤
奖励	嘉奖	褒奖	奖	赏	奖赏	记功	论功行赏	评功论赏
发奖	授奖	颁奖
金质奖	头彩	重彩
奖惩	奖罚	赏罚	信赏必罚
表扬	褒扬	表彰	褒	彰	旌
处罚	处分	责罚	惩罚	惩办	论处	罚	惩	判罚	重罚
开除	革除	开	除名
检讨	检查	反省	自我批评
选举	推选	推举	公推	选	推	举	选出
选拔	甄拔	挑选	遴选
提拔	提升	擢升	栽培	提挈	擢用	提干	晋职
聘请	聘任	聘用	延聘	延请	延	聘	请	招录	特聘
敦聘	礼聘
招聘	征聘	聘选	招贤纳士	选聘	招贤
征募	招募	征集	征召	征	招兵买马	招生	招收	招用
任命	任	授	除	选
委任	委派	委
封爵	封	拜	加官进爵	授衔	分封	授职
册立	册封
任用	起用	擢用	引用	叙用	重用	录用	选用	收录	录取	用	选定	量才录用	圈定
荫袭	荫	封妻荫子
撤职	革职	免职	罢职	去职	解职	停职	丢官	任免	撤掉
罢官	罢黜	黜免	罢免	斥退	靠边儿站	清退
贬谪	贬斥	贬黜	谪
雇用	雇佣	雇请	雇工	雇	佣	用活
解雇	解聘	辞退	辞	散	炒鱿鱼	辞掉
下任	卸任
就职	到职	到任	上任	走马上任	下车	下车伊始	就任	赴任	走马赴任	新任
接替	接手	接任	继任	接班	接	接办
交卸	移交	交代	交班	交接	交割
办公	办公室
办事	做事
出差	出勤	公出
值班	当班	值勤	值星	值日	轮值
守夜	值夜	夜班
巡夜	查夜
出巡	巡幸
清道	喝道	开道	鸣锣开道
建筑	建造	修建	修筑	兴修	构筑	建	筑	修	盖	打	盘	垒	砌	大兴土木	构	组构
动土	动工	施工	破土	破土动工
营造	营建
打夯	夯
改建	改造
翻修	翻盖	翻
基本建设	基建
架设	架	搭	架构
铺设	敷设	铺	街垒	铺就	铺砌
养护	护养	养	护
放置	码放
安装	装置	设置	安设	安	装	安上
装配	配
组建	组装
粉刷	抹灰	粉	垩	刷	涂刷
油漆	漆	油	髹	喷漆
装饰	装点	装璜	装修	点缀	饰	装潢	装裱
制造	制作	造作	打造	制	造	做	打	炮制	筑造
酿造	酿	酿制
仿造	仿制	克隆
再生	还魂	再造
造假	掺假	掺杂使假
修理	整修	修整	整治	收拾	拾掇	修补	修缮	修葺	修复	修	整	缮	葺	弥合
切削	铣	车
切割	割
焊接	焊
电焊	电弧焊接
铆接	铆
冶炼	冶金	熔炼	炼	炼制
锻造	打铁	锻	锻打	锻压
铸造	浇筑	熔铸	铸工	翻砂	铸	电铸	铸锭	浇铸	凝铸	烧造
轧钢	轧
冲压	冲
拉延	拉制
镀	鋈
熔化	熔	销	铄	回炉	熔融	熔断	炼化
淬火	蘸火	淬
锢露	锢	补
提纯	提炼	提制	炼	纯化
裂化	裂解
镶金	错金
漂白	漂
染色	染
印染	印花
编织	编制	编	打	织	结
缫丝	抽丝
排字	排版
付排	发排
印刷	印
装订	订
出版	问世
发行	刊行
再版	重版
勘察	勘查	查勘	踏勘	勘测	勘验	考量
勘探	钻探	探矿
测量	测
开矿	采矿	开采	采掘	采	采采
疏浚	疏通	疏导	宣泄	修浚	疏	浚	酾	瀹	疏开
治水	治理	治	治水改土
防洪	防汛
灌溉	浇灌	浇	沃	灌	灌输	浇水	浇地
开山	劈山
垦荒	垦殖	开荒	拓荒	开垦
屯垦	屯田
开拓	开辟	开发
种地	种田	稼穑
耕作	耕耘	耕种	耕地	佃
平地	整地	平整	平	耙	耢
破土	垦	坌
耕	犁
耦耕	秋耕	匀播耧
深耕细作	精耕细作
刀耕火种	火种刀耕
间作	间种
套作	套种
连作	重茬
轮作	轮种	倒茬
春化	催青
播种	下种
点播	点种	点	种籽	撒种
耧播	耩
种植	栽种	栽植	植苗	种	植	栽	稼	莳	种养
栽培	培植	秧
移栽	定植	移植
扦插	插条
培土	耔	翻地
嫁接	枝接	芽接	接穗
整枝	打杈
施肥	粪
条施	沟施
锄草	除草	芟除	耕田	挠秧	耥	荑	耨	芟
收割	收
打场	脱粒
打猎	狩猎	射猎	出猎	行猎	田猎	猎	田	畋	佃	围猎	捕猎	猎捕
捕鱼	打鱼	渔	渔猎	渔捞
钓鱼	垂钓	钓
撒网	网
畜牧	牧畜	饲养	养活	养
放牧	牧	放
饲养	畜养	驯养	喂养	调理	哺育	育雏	喂	饲	哺养	豢	豢养
肥育	育肥	催肥
养殖	繁育	培养	放养	养育
配种	配
阉割	去势	阉	劁	骟
屠宰	宰杀	宰	屠	杀	宰割
出产	生产	产	出	盛产	推出	搞出
贸易	交易	贸	市
通商	流通	商品流通
输出	出口
输入	进口	入口
投资	入股	注资	斥资
集资	合股
融资	筹融资
招股	募股
招揽	招徕	兜揽	兜	揽	拉	做广告	揽客
标价	明码
讲价	议价	讨价还价	易货
要价	讨价	开价
抬价	哄抬物价	加价
压价	杀价	砍价
成交	拍板
买	购	置	贩	打	请	办	进	市	赎	趸	贾	购买	购置	置备	置办	采购	采办	包圆儿	购入	购得	买入	选购	购进	买进	进货
收购	收买	买断	收订	购回
订购	定购	订货	定货	预购	预订	订	订座
邮购	函购
抓药	打药
卖	售	货	沽	贾	鬻	出卖	贩卖	出售	发售	售卖	趸售
倒卖	倒腾	购销	倒手
销售	销行	行销	销	售货
兜销	兜售	推销
经售	经销
专卖	榷
抛售	抛
批发	发行	批零	批销	联销
零售	零卖
寄卖	寄售
拍卖	甩卖	处理
出倒	招盘	出盘	盘店	倒	盘
出让	转让	让
变卖	变	换
脱手	出脱	出手
粜	出粜
炒买炒卖	炒卖	待价而沽
卖掉	卖出	售出
走俏	紧俏
出租	租	租借	租赁	招租	贳	租售
转租	包租	出顶	顶
租用	租借	租赁	赁	僦	包	顶	租下	承租
营利	赚	扭亏为盈	扭亏增盈	赚钱	扭亏解困	扭亏	创汇	创利
渔利	牟利	居奇牟利	谋利
分红	分配
翻本	捞本
兑换	换钱	换	兑
兑现	兑付	兑
放债	放款	贷款	借款	拆借	贷
借债	举债	借贷	告贷	贷	借款	筹借	筹资	举借
挪借	挪用	垫补	通融	东挪西借
摘借	摘
借支	透支	入不敷出
降息	减利
欠债	欠帐	负债	背债	拉亏空	拉饥荒	负债累累	欠资
欠	该	拖欠
赊欠	赊	挂帐	贳	欠账	赊账
讨债	索债	要帐	讨账	讨还	追回	追索
还债	折帐	偿还	偿付	还款	还贷
典当	典	当	典押	押当
抵押	押	抵	质	质押
抵账	抵债
赔偿	赔	包赔	赔付	赓
赔款	赔帐
理赔	索赔
赎回	赎
征收	征	敛	课	清收	征缴	执收
收费	收款	收贷
交纳	缴纳	上缴	缴	交	纳	完	上交	缴付	呈交
交款	缴费	交费
缴税	交税	纳税	上税	完税	收税
支付	支出	付出	开发	开支	开销	支	出	开
付帐	会帐	付	会	计付	给付	交账	付款
垫付	垫	垫款
付清	付讫
两讫	收讫
催讨	追缴	追交
划价	计费
偷税	偷逃税	偷漏税	骗税	逃税	避税	偷税	漏税
拨款	拨付
记帐	入帐
盘帐	查帐
销帐	核销
报帐	报销	实报实销
盘点	盘存	盘货	盘库
积累	累积	积聚	聚积	积攒	累	积	攒	积淀
积储	积蓄	蓄积
积久	日积月累	日就月将	积铢累寸	铢积寸累	积少成多	集腋成裘	聚沙成塔	群轻折轴	积弱积贫	积羽沉舟	始于足下	千里之行始于足下	涓滴成溪
花费	花	费	花消	消费
耗费	消耗	耗	吃	淘	损耗	磨耗
白费	枉费
浪费	旷费	糜费	抖搂	荒废	糟踏
挥霍	糟蹋	暴殄天物	悖入悖出	奢侈浪费
节省	节约	撙节	撙	节	省	省掉	省去
挤出	抽出	腾出
足够	十足	足	够	敷	够用	足足
相抵	抵消	平衡	抵
剩余	下剩	余下	剩下	剩余	多余	节余	结余	盈余
结存	留存	下存	现存	存
亏欠	亏空	亏累	亏
亏损	亏耗
亏本	亏蚀	赔本
缺少	短少	短缺	缺欠	短欠	缺乏	缺	乏	短	少	亏	欠	差	短斤缺两	不够	紧缺	缺失	匮缺
不足	欠缺	阙如	贫乏	贫	绌	供不应求	粥少僧多	僧多粥少	相差
遗漏	脱漏	落	脱	漏	挂一漏万	疏漏	漏掉
合计	共计	总计	综计	一共	拢共	统共	总共	合共	一起	共总	归总	一总	共	凡	合	一股脑儿	累计
驾驶	驾	开	驾驭
驾车	驱车	开车	出车
驾御	赶	驱	策	御
搭客	拉脚	捎脚	拉客
搭乘	乘	坐	搭	代步
行驶	驶	行驶
疾驶	奔驶
航行	航
航空	宇航	飞行	飞
上水	上行	上溯
下水	下行
巡航	巡弋	游弋
划船	摇船	行船	划桨	泛舟	竞渡	翻浆
旅行	行旅	远足
出行	出外	外出	远门
远行	出远门	长征	远涉重洋	远征	飘洋过海
跋涉	跋山涉水	翻山越岭	涉水	长途跋涉
舟车	车马	鞍马
同路	同行
出境	离境	出国	出洋	远渡重洋	过境
赶路	趱行	趱	兼程
抄道	抄近路	抄近儿	抄小路
绕道	绕远儿	绕圈子
带路	引路	领路	领道	向导	先导	前导	引导	指引	带领	带	领	引	导	指路
引航	引水	领港	领江
领航	导航
搬运	搬	盘
运输	输	运	运送	运载
河运	漕运
驳运	驳
流放	放
押运	押送	押车
装载	装	载
经过	经由	路过	行经	途经	经	过	由	通	历经
越过	穿过	通过	穿	过	穿越
渡河	摆渡	渡	航渡
拐弯	转弯	拐弯抹角
急弯	急转弯
离开	撤离	背离	开走	去	走	撤出	走人	离去
滚蛋	滚开	滚	走开
背井离乡	离乡背井	离家	远离	离乡
返回	归来	回来	回去	返	归	回	赶回	回到
返乡	还乡	回乡	叶落归根	落叶归根
荣归	衣锦还乡	荣归故里
回家	还家	打道回府	返家	金凤还巢	倦鸟投林
折回	转回	退回	撤回	折返	重返
复归	复返
到达	抵达	达	抵	至	到
停靠	停	靠
停泊	下碇	抛锚	泊	湾
教育	教导	教化	感化	教诲	训诲	训迪	启蒙	诲	傅	春风化雨	耳提面命	施教	化雨春风	有教无类	育
谆谆教导	循循善诱	诲人不倦	谆谆教诲
安居而乐教	安居乐教
传授	传	授	相传	口传心授	衣钵相传	灌输	授受
示范	示例	以身作则	言传身教	现身说法	演示	为人师表	身教胜于言教
开导	诱导	启发	启示	启迪	诱	诱发	迪
发蒙	启蒙
指点	指	点	指导	点拨	点化
唤醒	唤起	提醒	提拔	发聋振聩	提示	抛砖引玉
引导	指引	引	导	带	因势利导	指点迷津
化装	扮装	装扮	扮	假扮	上装	扮成
卸妆	卸装	下装
修养	修身	养气	修身养性
摄影	留影	拍摄	拍照	照相	照	摄	拍	摄像	摄录	录像
调焦	测距
曝光	暴光
冲洗	洗印	显影	洗	冲	印
录音	灌音
放映	上映	播出	播映	公映
广播	播送	播音	放送	播发	播放	播	播讲	播报
管教	教养	调教	管	管束	辖制
教训	训	训诫	训导	训话
警告	警戒	告诫	以儆效尤	提个醒	警示
讲课	授课	讲授	讲解	教授	教书	教学	讲学	执教	上课	上书	主讲	教	教课	任课	授业	传经授道
讲习	传习	教学
训练	训	教练
练习	操练	操演	演习	练兵	习	练	勤学苦练
练嗓子	吊嗓子
演武	练功	练武
锻炼	锤炼	磨练	磨砺	砥砺	淬砺	闯练	闯	千锤百炼	久经考验	磨炼	锻锤	闯荡	洗炼
练出	练就
强身健魄	强身健体
培养	培植	扶植	培训	陶铸	栽培	造就	培	树	养	造	培育	塑造	铸就
育人	教书育人
试验	实验	尝试	试行	试
考试	考	试	试验	测验	考查
大考	期考
应试	应考	下场	赶考
春试	会试
发射	发出	放
学习	念书	读书	上学	就学	求学	修业	攻读	深造	读	念	学	习	上	攻	修	学学
复习	温习	温课	复课	习	温书
自学	自习	自修	进修
实习	见习
半工半读	勤工俭学	勤工助学
取长补短	用长避短
囫囵吞枣	生吞活剥	不求甚解
重读	复读
从师	投师	拜师	受业	执业
模仿	效仿	仿效	模拟	仿照	取法	师法	效法	宪章	祖述	踵武	学舌	因袭	依傍	效尤	仿	法	摹	学	套	效	拟	东施效颦	邯郸学步	鹦鹉学舌	照猫画虎	照葫芦画瓢	依样画葫芦	如法炮制	人云亦云	亦步亦趋	摹仿
上行下效	上梁不正下梁歪
留学	留洋	镀金
逃学	旷课	逃课
阅读	阅	读	看	读书	开卷	翻阅	阅览	披阅	涉猎
默读	默诵
读报	看报
查阅	查看	查	翻	翻开	翻动	翻看
朗读	宣读	诵读	读	念	诵	朗诵	讽诵
吟咏	咏叹	吟唱	吟诵	哼唧	吟	咏	叹	哼	唪	沉吟
唱酬	酬和	唱和	步韵	和	一唱一和
诗朗诵	吟诗
背诵	记诵	诵	背	背书
挥笔	挥毫	挥洒	执笔	落笔	书写	命笔	着笔	下笔	写	书	泐	题	修	开	秉笔直书
大写	小写	大处落墨	大书特书	题诗	题写	奋笔疾书
填	填写	填充	填空	填入
代笔	捉刀
手书	亲笔
抄写	誊写	缮写	誊录	誊清	抄录	抄	录	缮	誊	手抄	传抄	照抄	抄送
临摹	摹写	描摹	影	描	临	临帖
默写	默
涂抹	涂鸦	划拉	划线	写道
划	扛
提行	抬头
记录	笔录	著录	记下
记	笔记	速记	简记
手记	手写
摘记	摘录	摘由	摘要	节录	选录	摘抄
附笔	附言	附记
解释	解说	分解	说明	说	讲	诠	释	诠释	训诂	释疑
注释	诠注	诠释	注解	注	笺注
引证	引用	摘引	征引	援引	援用	援	旁征博引	引述
用典	用事	引经据典
参阅	参见	参看	参照	参考
介绍	说明
标注	标明	标号	标	号	标出
标点	圈点	断句	圈
评点	批
分析	辨析	剖析	剖解	析	剖	条分缕析	浅析	解析
推敲	琢磨	斟酌	锤炼	字斟句酌	切磋琢磨	推磨
去粗取精	去伪存真
研究	钻研	钻	研	研讨	切磋
探究	探索	探讨	根究	推究	深究	追究	追	探赜索隐
追根	追溯	刨根儿	顺藤摸瓜	寻根究底	追根究底	推本溯源	追本穷源	穷原竟委	穷源溯流	刨根问底	追根问底	穷根究底
抠	抠字眼儿	钻牛角尖	咬文嚼字
考证	考据	查考	考究
分类	分门别类	分拣	归类
归纳	归结	概括	总括	综合	综	综上所述	综述	汇总	集锦
总结	小结	下结论	总
推理	推导	推求	推演	演绎
类推	类比	举一反三	触类旁通	以此类推	依此类推
写作	著作	创作	编写	编	撰	写	著	做	作	作文	缀文	行文	撰著	编著	著述	立言	命笔	笔耕	耍笔杆	著书立说	著书	著文	撰写	练笔	撰文	爬格子	文墨
起草	草	起	拟	草拟	拟稿	拟议	起稿
布局	搭架子
执笔	动笔
完稿	杀青	汗青
编造	臆造	虚构	虚拟	杜撰
堆砌	雕砌	寻章摘句	舞文弄墨	叠床架屋
谱曲	作曲	谱写
作诗	赋诗	咏	吟风弄月	嘲风咏月
合著	合写	合编
编成	作出
翻译	翻	译	通译	重译
音译	译音
编辑	编纂	编撰	编写	编制	修	编	纂	辑	缀辑	编排	编次
编录	辑录	摘录	剪辑	剪接
补遗	补正	增补	拾遗	拾遗补阙
校对	校	校改	审校	校准
校订	校勘	校核	校正	校阅
润色	润饰	修饰	点染	增辉
修改	改动	改	窜	窜改	雌黄	涂改	修定	修修改改	改改	批改
更正	修正	匡正	匡
指正	雅正	呈正	斧正
删改	删节	删繁就简
删除	剔除	芟除	去除	除去	删	剔	抹	勾	去	删去	刨除	删减
改错	纠错
修订	审订	考订
订正	勘误	正误
绘画	描画	描绘	画	绘	写	描	打	写生	点染	画画	作画
画像	写真	传真
勾	勾勒	勾画
着色	上色	设色
渲	渲染
制图	绘图	绘制	打样	作图
雕刻	镌刻	镂刻	镂空	雕琢	琢磨	雕	刻	镌	抠	勒	錾	锓	镂	锼	精雕细刻	雕饰	摹刻
雕花	镂花
医治	医	治	看	疗	治病	看病	医疗	治疗	诊疗	诊治	临床
诊	听诊	诊察	诊视
诊断	确诊
诊脉	号脉	切脉	把脉	按脉
行医	救死扶伤
就医	就诊	看病	诊病
求医	求治
救治	救护	抢救	急救	急诊
消毒	杀菌
刮痧	揪痧
修补	修复
消肿	消炎
打针	注射
扎针	针刺
补液	输液
种痘	种牛痘	种花
开刀	动手术
配药	配方
下药	投药	用药	施药
接生	接产
打胎	刮宫	人流	人工流产	堕胎
演出	表演	演	上演	公演	献艺	献技	卖艺	演艺
配戏	跑龙套
会演	汇演
预演	试演
武打	短打	打出手
打诨	插科打诨
出台	出场	上	上场	上台	登台	登场	鸣锣登场	出演
下台	下场	下
排演	排戏	排练	排	彩排	演练
扮演	饰演	装扮	串演	串	扮	饰	装	去	扮作
唱歌	唱	歌	讴歌	歌唱	歌咏	讴
高唱	高歌	欢歌	引吭高歌
悲歌	长歌当哭
哼	哼唧	哼唱
对唱	对歌	对口
帮腔	和
变调	移调	转调
跳舞	舞蹈	舞	翩翩起舞	翩跹起舞	翩然起舞	婆娑起舞	起舞
歌舞	轻歌曼舞	载歌载舞
演奏	奏乐	作乐	吹打	奏
吹奏	吹	品
弹奏	弹
拍板	击节	打拍子
发球	开球
拦网	封网
踢球	蹴鞠
打拳	练拳
溜冰	滑冰
游泳	游水	游	击水	冲浪
蝶泳	海豚泳
下棋	着棋	对弈	对局	弈	博弈
将	将军
比赛	竞赛	比试	竞技	较量	交锋	角	斗	比	赛	竞
赛马	跑马
争衡	夺标	摆擂台	打擂台	见高低	决一雌雄	决一胜负
奥林匹克	奥运会
争奇斗艳	争妍斗丽
见分晓	见雌雄
胜利	夺魁	胜
蝉联	卫冕
交际	应酬	酬酢	酬应	周旋	张罗	社交	打交道	交道
交往	来往	往来	往还	走动	走	过从	过往	往复	接触	一来二去	有来有往	明来暗往	酒食征逐
结交	相交	缔交	神交	交接	交游	会友	结识	交	轧
交好	通好	修好	亲善	友善	相好	和睦相处
拉关系	拉交情	套交情	套近乎	拉近乎	搞关系
处世	做人	待人接物	立身处世	为人处事	作人
相处	相与	处
睦邻	友邻
凭借	借助
访问	拜访	拜谒	拜会	造访	走访	做客	作客	拜望	访	拜	看	顾	聘	寻亲访友
登门	上门
回访	回拜
进见	晋见	参见	谒见	晋谒	参谒	参拜	拜见	见	拜
朝见	觐见	朝觐	上朝
探望	看望	省视	探视	探访	探问	看	望	瞧	探	省	看看	细瞧
省亲	探亲
走亲戚	串亲戚
串门子	走门串户	走村串户	串门	走家串户	走街串户	跑门串门	走村串寨	走街串巷
邀请	约请	敦请	特约	邀	约	请	三顾茅庐	敬请	特邀	有请	诚邀
邀集	约集
约定	说定	预定	预约
约稿	稿约
赴约	践约	履约	应邀
守信	言而有信	一诺千金	一言为定	说到做到	守信用
算数	算	作数
践诺	实践	还愿
失信	食言	黄牛	自食其言	食言而肥	背信弃义	言而无信	出尔反尔	轻诺寡信
失约	负约	破约	违约	爽约
翻脸	闹翻
迎接	迎迓	迎候	出迎	欢迎	迎	接	逆	迓
迎宾	夹道欢迎	喜迎	笑脸相迎
会面	见面	晤面	会见	会	晤	会晤	会客	碰头	照面	相会
陪伴	陪	伴	陪同	伴同	随同	伴随	奉陪
做伴	作陪	为伴	相伴	作伴
接送	迎送
送别	送行	欢送	送客	送
饯行	饯别
告别	告辞	辞别	拜别	辞行	辞
等候	听候	伫候	守候	等候	候	等	待	俟	虚位以待	伺机	拭目以待	等待
少待	稍候
坐等	坐待
有待	有待于
驱逐	赶走	赶跑	赶	轰	撵	逐	扫地出门	驱遣	驱赶
收留	收容	收养	容留
挽留	款留	留
招呼	打招呼
招待	接待	款待	待	遇	待遇
对待	对	待	待遇	看待	相待
宽待	优待	厚待	恩遇	礼遇
虐待	凌虐	肆虐
对付	应付	缠
过场	走过场	逢场作戏
敷衍	应付	搪塞	应景	搪	虚应故事	虚与委蛇	敷衍了事	敷衍塞责	含糊其词
祝愿	祝	祝颂	祝福
祝贺	庆贺	道贺	道喜	庆	贺	拜	恭喜
庆祝	庆	欢庆
贺年	拜年	恭贺新禧	贺岁	贺春	团拜
祝寿	拜寿	纪寿
闹新房	暖房
请安	问安	问好	问候	问讯	致意	致敬
写信	来信	通信	致函	修函	上书	鸿雁传书	致信
投书	投送	下帖	寄信	发信
复信	回信	复	函复	回函	复函
汇款	邮汇	信汇	电汇	汇	邮	汇寄
邮寄	付邮	邮	寄	投	邮递	邮发
投递	递送	送
拍电报	发报	电告	电	打电报	发电	致电
打电话	挂电话	通电话	通话
讲话	说话	谈话	发话	出言	开口	出口	开腔	张嘴	呱嗒	言语	说	谈	操	道	语	言	讲	叙	称	云	曰	提	唠	摆	说道	讲讲	谈道
吭声	吭气	吭	做声	则声	启齿	吱声
耳语	私语	低语	咬耳朵	咕唧	哼唧	喳喳	囔囔	嘀咕	窃窃私语	交头接耳	轻言细语	喃语	细语
咕哝	咕唧	咕噜	嘟囔	嘟噜	自言自语	自语	夫子自道	念念有词	唧哝
唠叨	叨唠	絮叨	絮语	饶舌	多嘴	磨牙	耍贫嘴	耍嘴皮子	磨嘴皮子	刺刺不休	呶呶不休	哓哓不休	喋喋不休	念叨
噜苏	赘言	赘述	废话	费口舌	哩哩罗罗
炒冷饭	旧调重弹	重提
瞎说	乱说	胡说	胡扯	瞎扯	瞎诌	嚼舌	放屁	乱弹琴	胡言乱语	胡说八道	说梦话	鬼话连篇	信口开河	信口雌黄	言不及义	胡言	胡诌	戏说
吞吐	吭哧	支吾	闪烁其辞	含糊其辞	吞吞吐吐	支支吾吾
直言	和盘托出	直言不讳	仗义执言	开门见山	打开天窗说亮话	直抒己见	直说
倾诉	倾吐	倾谈	倾倒	诉	吐诉	一吐为快
诉说	陈诉	诉
鼓舌	摇唇鼓舌	花言巧语	哗众取宠	巧言如簧	能说会道	调嘴弄舌
插话	插嘴	插口	多嘴
搭腔	搭话	搭理	答茬儿	接茬	搭讪
说笑	耍笑	谈笑	笑语	有说有笑	谈笑风生	欢谈
会话	对话	人机会话
侈谈	唱高调	夸夸其谈	高谈阔论
空谈	放空炮	说空话	坐而论道	纸上谈兵	空口说白话
话旧	叙旧
话别	叙别	道别
交谈	叙谈	攀谈	搭腔	过话	交口
面谈	晤谈	面议
泛泛而谈	浅说	清谈
恳谈	交心	谈心	促膝谈心	娓娓而谈	娓娓道来	长谈
畅谈	倾谈	畅叙	畅所欲言	倾心吐胆
漫谈	纵谈	漫话
断言	预言
说闲话	闲言闲语	说长道短	说三道四
冷言冷语	吹冷风	泼冷水
慷慨陈辞	侃侃而谈
一语道破	一语破的	一针见血
总而言之	总之	一言以蔽之	总的说来	总起来讲
欢歌笑语	欢声笑语
致词	致辞
谈天	聊天儿	闲扯	拉扯	闲谈	聊	闲聊	闲话	说闲话	拉	扯	扯淡	闲磕牙	拉家常	话家常	叙家常	摆龙门阵	谈天说地	东拉西扯	侃侃	你一言我一语	促膝交谈	聊聊	聊天	侃	谈古论今
神聊	说东道西	拉三扯四
演讲	讲演	演说	发言
论述	论说	阐述	阐释	阐发	论
列举	罗列	胪列	论列	数说	毛举细故	历数	点数
叙述	叙说	讲述	叙	平铺直叙	描述
陈述	陈说	胪陈	陈	述	陈言
详述	慷慨陈词	前述	细说	详谈
铺叙	铺陈	敷衍	缕述	缕陈
述说	称述	诵
追述	追叙	记述	忆述
记叙	记事	记载	叙写
声称	宣称	宣示	扬言	声言	声明
描写	描绘	写	状	描摹	刻画	形容	勾画	勾勒	勾	摹写	写照	抒写
写实	写真
表示	示意	表
吹风	放风
志	道	申	鸣
暗示	丢眼色	使眼色	授意
表达	抒发	发表	抒	达	发挥	表述	致以
抒情	抒怀	抒情畅怀
阐明	阐发	发明	说明	表明	申明	申说	申述	申	表
表白	剖白
表露	吐露	披露	透露	说出	露
发誓	盟誓	立誓	宣誓	起誓	赌咒	誓	矢	誓死
告诉	告知	奉告	报告	告	晓	喻	语	报
禀告	禀	回禀
晓谕	晓示	诰	诏	谕
转告	转达	传达	传言	传话	过话
预告	预报	测报
告警	报警
告捷	报捷
通知	知照	关照	知会	照会	通告	通	通报	报信	送信儿	打招呼
透风	通风报信
嘱咐	叮嘱	丁宁	交代	嘱	叮	授	叮咛	嘱事
介绍	引见	牵线	穿针引线
说合	撮合	说	说说
说媒	做媒	保媒	说亲	提亲
搭桥	牵线搭桥
推荐	引荐	举荐	荐举	荐	援引	引进	推举	搭线	推介
保荐	保举	保送
自荐	毛遂自荐	自告奋勇
露面	照面儿	露头	抛头露面	冒头
出面	出名	出台	出头	出马	出头露面
代替	代表	替代	顶替	取代	代	替	取而代之	指代
替班	顶班
问	发问	提问	讯问	问讯	叩问	叩	问话	问问	询	诹	咨询	訾
查问	查询	询问	咨	诹
盘问	细问	盘诘	问长问短	盘根究底
追问	诘问	追询
反问	反诘
责问	诘问	质问	问罪	喝问
质问	质疑	质疑问难	质询
请示	请命	报请
答	回答	回复	对答	答应	应答	答复	答话	回话	答对	应对	酬对	酬答	酬	对	应	回	报	答问	回应	作答	解惑	答疑
对质	对簿	对证
吹牛	说嘴	夸口	吹	说大话	夸海口	吹牛皮	口出狂言	大言不惭	胡吹	诩
自夸	自诩	伐	自卖自夸	自吹自擂	卖狗皮膏药
吹嘘	鼓吹	标榜	美化	树碑立传
夸张	虚夸	浮夸	夸大	夸耀	夸	夸大其词	言过其实	夸大其辞
说谎	扯谎	撒谎	扯白	佯言	瞎说	说鬼话	说瞎话	胡诌
造谣	造谣惑众	谣言惑众	妖言惑众	蛊惑人心	造谣中伤	飞短流长	凭空捏造
放空气	放冷风	放风
隐瞒	隐秘	隐匿	背	瞒	背着	闭口不谈	不说
掩盖	掩饰	遮盖	遮羞	遮掩	隐讳	讳言	讳	讳莫如深
打掩护	打埋伏
粉饰	矫饰	文饰	文过饰非	涂脂抹粉	粉饰太平	搽脂抹粉
保密	秘	守口如瓶
揭露	揭发	揭破	点破	揭	揭底	揭开	揭秘
揭穿	说穿	拆穿	戳穿	捅	抖搂	揭老底	揭短
责备	责怪	指责	斥责	叱责	指斥	痛斥	训斥	申斥	指斥	指摘	非难	责难	非议	诟病	弹射	申饬	数说	数落	数叨	抢白	责	斥	怨	谪	非	咎	骂	怪	呲	熊	派不是	痛责	喝斥	横加指责	微辞	指指点点
自责	自咎	引咎	引咎自责	自我批评
苛责	求全责备
谴责	声讨	申讨	谴
批评	开炮	放炮	针砭	针砭时弊
批判	批	揭批
批驳	驳斥	驳倒	反驳	驳
抹杀	勾销	一笔抹杀	一笔勾销	一棍子打死	一笔抹煞
攻击	抨击	掊击	鞭挞	大张挞伐	口诛笔伐	挨斗	讦
承认	确认	认可	肯定	认同	认账
认错	认罪	认输	认命
否认	否定	不认帐	矢口否认	矢口
抵赖	狡赖	赖	矢口抵赖	赖帐	赖债	赖皮	赖账
过问	干预	干涉
介入	参与	沾手	插手	插足	插身	厕身	厕	与	涉足	踏足	涉企
打听	探听	打探	探问	打问	询问	叩问	探询	刺探	摸底	了解	问询	垂询
摸清	探明	摸透
试探	试	探	诈	探口气	探路	探察
请求	乞求	恳求	央求	央告	求告	呈请	恳请	吁请	呼吁	伸手	求	央	要	告	请	吁
求助	求援	乞援	告急	求救	呼救
求饶	告饶	讨饶
哀求	哀告	央求
征求	征询	征	征得
乞怜	摇尾乞怜	乞哀告怜
委托	付托	嘱托	信托	寄托	托付	托	寄
拜托	央托	托人情	托人
讲情	说情	求情	讨情	说项	美言	缓颊
赠送	馈送	奉送	馈赠	捐赠	赠与	馈	赠	饩	赍	贻	送	遗	给	赠给	赠予
转送	转赠	借花献佛
送礼	送人情
回礼	还礼	回赠
赏赐	赏	赐	赉	贶	赐予
赠答	投桃报李	礼尚往来	互通有无
捐献	捐	输	白送
献	奉	呈献	贡献	奉献	孝敬
进贡	朝贡
捐给	献给
交	提交	交付	交给	付诸	付出	付	授	送交	给出	交到	交由	付给
呈	上
面交	递交	呈递	递	呈送	递给
转交	转送	传递	传送
付费	付钱
取	领取	提取	提	领	领到
借	借用	假	借出
出借	借给	借	放贷	贷出
归还	发还	奉还	清还	清偿	偿清	偿还	偿	还	归	璧还	完璧归赵	送还	物归原主	还给
退还	退回	退	吐出	退赔	赔还	退掉	清退
交换	互换	掉换	串换	对调	换	易
掉包	偷梁换柱	偷天换日
更换	更替
传递	传接	传送
催促	催	促
抵偿	抵	偿
感谢	感	谢	谢谢	道谢	称谢	致谢	申谢	鸣谢	璧谢	感恩戴德
酬谢	酬答	酬劳	酬报	酬	酬宾
答谢	谢恩
报答	报偿	报	答	补报	结草衔环	报经
道歉	致歉	赔罪	赔礼	赔不是	赔小心	赔礼道歉
请罪	负荆请罪
谦让	礼让	忍让	推让	辞让	让	让给
让座	让位
让路	让道
让步	退让	退避三舍	服软
迁就	将就
协商	相商	筹商	磋商	情商	商谈	商议	计议	协议	商讨	商榷	商量	商兑	商酌	商计	合计	说道	商	议	谋	共谋	共商	商事	议商	协和
谈判	交涉	讨价还价	折冲樽俎
会商	会谈
接洽	面洽	洽	商洽	洽商	洽谈
和平谈判	和谈
订约	缔约	立约	缔结	签订	订立	订	立	协定	约法三章	立下	商定
答应	应	应允	许	诺	应诺	承诺	然诺	许诺	允诺	应承	承当
允许	容许	同意	允	容	兴	许
拒绝	回绝	拒	推却	推辞	不容	驳回	拒谏饰非	拒人千里	闭门羹	拒人于千里之外	不肯
谢绝	辞谢	谢却	婉辞	回绝	敬谢不敏	婉言谢绝	婉拒
推托	推	假托	托	借口	推三阻四	托辞
搪塞	搪
推卸	推委	推脱	推	卸	溜肩膀	推诿	踢皮球	诿
委罪	归咎	归罪	罪
鼓励	勉励	打气	砥砺	嘉勉	慰勉	劝勉	勉	劭	励	鞭策	励人	懋	钊	勖
激励	激扬	激发	鼓劲
劝告	相劝	规劝	奉劝	劝导	劝戒	劝诱	劝说	劝	侑	规	箴	告诫	好说歹说	劝诫	谆谆告诫	横说竖说	敦劝
规谏	进言	谏	诤	谂
游说	说
劝阻	劝止	劝退
安慰	劝慰	抚慰	安抚	抚	慰	慰藉	温存
慰劳	慰问	抚慰	劳	犒劳	犒赏	慰唁	问寒问暖	嘘寒问暖
帮助	扶助	协助	赞助	援助	臂助	救助	匡助	辅助	襄助	相帮	帮忙	帮衬	支援	增援	声援	搭手	援手	扶持	扶植	扶	拉扯	扶掖	提携	提挈	助	帮	辅	援	拉	襄	协	匡扶	受助	帮带	佑助	八方支援	鼎力相助	有难必帮	相助	帮扶
互助	互济	相濡以沫	互帮互助
周济	接济	救济	济	施舍	济贫	慷慨解囊	解囊相助	助人为乐	仗义疏财	济困扶危	扶贫	扶贫帮困	杀富济贫	济困	帮贫济困	扶贫济困	帮困	助困	扶贫助困	解困扶贫
救急	雪中送炭
帮衬	补助	捐助	资助
赈济	赈
行善	行好	行方便	积德	行善积德	与人为善
成全	周全	作成	圆成	玉成	成人之美
辅佐	佐
助威	助战	捧场	摇旗呐喊	呐喊助威
支持	帮腔	撑腰	敲边鼓
打下手	跑腿
拯救	救	拯	搭救	解救	抢救	营救	匡救	挽救	援救	救援	匡	救苦救难	救死扶伤	普渡众生	从井救人	救危排险	救难	救救	施救	驰援
救命	救生	救人
救火	扑救	灭火	扑火
救活	活命	活
救应	接应
献计	献策	出点子	出谋划策	摇鹅毛扇	出谋献策	建言献策
照顾	照拂	照料	照应	照看	照管	看管	看	关照	招呼	观照
服侍	伺候	侍奉	事	侍	侍候	侍弄	伴伺
护理	看护	守护	照护	护养	医护
保护	掩护	卫护	护卫	护	保安	保障	维护
保驾	保镖
护身	防身
收养	认领
领养	抱养	抱
抚养	拉扯	养活	扶养	拉	育	养	养育	鞠
保育	抚育	护养
赡养	奉养	供养	供奉	养老	菽水承欢
遵守	信守	严守	死守	恪守	守	遵	遵照	遵从	遵循	迪	恪	听命
遵命	奉命	从命	遵奉
听从	顺从	依从	服从	依顺	顺	从	依	听	服帖	伏帖	顺服	言听计从	从善如流	从谏如流	伏贴	服服帖帖	顺乎
违背	违反	违拗	违	迕	拂	失	负	背	背弃	背离	背道而驰	反其道而行之
违犯	触犯	犯忌	犯
抗拒	抗	抗命	对抗	违抗	抵制
称赞	夸赞	咏赞	称誉	赞誉	赞美	赞叹	赞颂	叹赏	称赏	赞赏	称道	称许	称颂	赞扬	揄扬	颂扬	褒扬	歌颂	讴歌	歌唱	嘉许	赞许	褒奖	夸奖	抬举	叫好	赞	誉	嘉	称	颂	褒	夸	许	拍手叫好	礼赞	赞叹不已	啧啧称赞
盛赞	叹为观止	拍案叫绝	交口称誉	有口皆碑	口碑载道	歌功颂德	赞不绝口	盛誉	交口称赞	众口交赞
过奖	过誉
耻笑	取笑	讥笑	嘲笑	讪笑	嗤笑	见笑	笑	笑话	寒碜	寒伧	贻笑大方
讥讽	嘲讽	讽	讽刺	讥诮	讥嘲	讥	挖苦	揶揄	奚落	反唇相讥	冷嘲热讽	诮
丑化	搞臭	抹黑
诬蔑	污蔑	诬赖	诬陷	诋毁	诽谤	毁谤	中伤	非议	訾议	造谣	谗	诋	谤	含血喷人	血口喷人	造谣中伤	恶语中伤	吡	谣诼	姗
反咬一口	倒打一耙
争论	争议	计较	争辩	争执	说嘴	争	争长论短	争持	争斤论两	争论不休
辩论	辩	争辩	声辩	申辩	置辩	答辩	说理	讲理	论理	论战	论争	驳	辩驳	反驳	回驳	驳斥	舌战	辩解	辩护	争鸣	理论	舌剑唇枪	力排众议
分辨	分说	辩白	辩解	分辩
狡辩	强辩	诡辩	鼓舌	胡搅	巧辩
议论	讨论	讲论	座谈	谈论	谈谈
公议	公论
妄下雌黄	信口雌黄	强作解人
街谈巷议	议论纷纷	说长道短	说短论长
大放厥词	厥词
骂	詈
责骂	叱骂	斥骂	唾骂	叫骂	骂街	骂骂咧咧
痛骂	臭骂	破口大骂
咒骂	诅咒
怒斥	叱喝	叱	怒骂
呵责	呵斥	申斥
辱骂	诟骂	漫骂	漫骂	笑骂	谩骂
对骂	骂架
争吵	吵	口角	吵嘴	争嘴	斗嘴	拌嘴	口舌	扯皮	吵架	抬杠	抬	破脸	抓破脸
顶嘴	还嘴	回嘴	强嘴
顶撞	顶
吵闹	闹	嚷	哄	起哄	叫嚣	大吵大闹	又哭又闹	哭闹	骂娘	有哭有闹
闹意见	闹别扭
作对	顶牛儿
殴打	打	殴	动武	挥拳	拳打脚踢	殴斗
打架	对打	争斗	搏斗	格斗	抓挠	动手	动武	交手	打	斗	大打出手	斗殴	打斗	搏	搏杀	大动干戈	角斗	揪斗
打伤	击伤
调解	排解	调停	调处	调和	劝和	说和	说合	疏通	斡旋	打圆场	和稀泥	息事宁人	排难解纷	圆场
拉架	劝架	劝解	解劝
屈服	慑服	降服	臣服	低头	屈从	让步	妥协	投降	伏	服	降	俯首称臣	拗不过	折衷
降伏	收服	降	服	伏	驯	驯服	折服
说服	以理服人	说动	疏堵
讲和	媾和	言和	议和	和解	和好	和	言归于好	握手言欢	握手言和
谄媚	献媚	狐媚	阿谀	谄谀	讨好	买好	卖好	取悦	吹捧	捧场	奉承	巴结	逢迎	拍	捧	谄	阿	谄	媚	献殷勤	抬轿子	吹吹拍拍	戴高帽子	投其所好	偷合苟容	曲意逢迎	胁肩谄笑	溜须拍马	谀	阿谀逢迎	阿谀奉承	点头哈腰	拍马屁	曲意奉承	巴结	恭维
笼络	牢笼	收揽	收买	拉拢	收拢	怀柔
攀附	攀缘	夤缘	趋附	趋奉	攀龙附凤	如蚁附膻	趋炎附势
迎合	投其所好
包庇	庇护	袒护	护短	庇荫	荫庇	党	打掩护	官官相护	猫鼠同眠
偏袒	偏护	偏向	向着	左袒	左右袒
放任	任凭	听凭	听便	听任	听	任	纵	放	逞	放任自流	任其自流	听其自然	听之任之	自由放任
姑息迁就	牵就
纵容	纵令	放纵	娇纵	惯
姑息	宽纵	姑息养奸
自暴自弃	破罐破摔
欺骗	蒙骗	诓骗	诈骗	哄骗	瞒骗	诱骗	瞒哄	欺诈	哄	诓	欺	骗	蒙	虞	诈	谩	谲	尔虞我诈	招摇撞骗	掩人耳目	尔诈我虞	障人眼目	坑蒙拐骗
耍花招	耍花腔	玩花样	作假	使坏	耍滑头	弄虚作假	耍花枪	耍滑	耍手段	耍心眼儿	偷奸取巧	偷奸耍滑	投机取巧	钻空子
欺瞒	蒙蔽	蒙哄	蒙混	打马虎眼	欺上瞒下	瞒上欺下	瞒天过海
迷惑	糊弄	惑	故弄玄虚	惑人耳目
偷梁换柱	偷天换日
自欺欺人	掩耳盗铃	掩目捕雀	瞒心昧己
骗人	坑人
捣鬼	搞鬼	做鬼	弄鬼	做手脚	上下其手	耍花样
得罪	冒犯	触犯	冲犯	冲撞	顶撞	唐突	撄	犯	太岁头上动土
激怒	触怒
纠缠	软磨	缠绕	蘑菇	泡蘑菇	磨蹭	磨	嬲	缠	绕	胡搅蛮缠	死皮赖脸	死气白赖	磨嘴皮
抓辫子	揪辫子
打搅	搅	打扰	搅扰	烦扰	干扰	侵扰	惊扰	惊动	搅乱	捣乱	扰乱	搅和
麻烦	烦劳	劳神	费事	劳驾	劳	烦	赘	找麻烦	添麻烦	困扰
阻拦	阻挠	阻挡	阻止	拦阻	拦挡	拦截	掣肘	梗阻	挡驾	阻碍	窒碍	阻遏	遏止	阻	拦	遮	挡	阻截	阻滞	截住	拦住	挡住	堵住	封阻	力阻	遮拦	截留
堵嘴	免开尊口	阻断
挡路	阻路	封路
拉后腿	扯后腿	拖后腿
拆台	挖墙脚	拆墙脚
耍赖	撒赖	撒泼	撒刁	耍无赖	耍赖皮	耍流氓
刁难	放刁	作梗	难为	作难	为难	留难	作对	拿人	拿	窘	过不去	百般刁难	出难题
挑剔	挑眼	挑刺儿	找碴儿	吹毛求疵	挑毛拣刺	挑字眼儿	咬字眼儿	挑毛病	横挑鼻子竖挑眼
引逗	挑逗	逗引	逗弄	逗	招惹	招	惹	撩
戏弄	捉弄	作弄	调弄	撮弄	嘲弄	耍弄	玩弄	调戏	调侃	戏耍	戏	耍	玩儿	愚弄	愚	恶作剧
开玩笑	调笑	戏谑	谐谑	斗嘴	开心	谑	打哈哈	寻开心	逗闷子	闹着玩儿
逗笑儿	逗乐儿	逗趣儿	凑趣儿	打趣	打趣逗乐	逗笑	逗趣
摆布	摆弄	播弄	拨弄	任人摆布
怂恿	唆使	嗾使	教唆	挑唆	撮弄	扇动	扇惑	诱惑	撺掇	撺弄	煽风点火	煽	煽动	煽惑	怂	顺风吹火
指使	主使	让	叫
强迫	逼迫	强逼	迫使	强使	驱使	驱策	勒逼	勒	迫	逼	催逼	强求	紧逼	进逼
勉强	强人所难	勉为其难
挟制	强制	要挟	挟持	胁持	劫持	裹胁
恐吓	恫吓	威吓	吓唬	惊吓	吓	唬	诈唬	哄吓
威胁	威慑	胁迫	威逼	胁	胁从
核威胁	核威慑
引诱	勾引	利诱	诱惑	诱	饵	啖	吊胃口	引蛇出洞	威胁利诱	循循诱人	煽惑	诱使
欺负	欺侮	欺凌	欺压	欺生	凌虐	侮	气	暴	凌	以强凌弱	谄上欺下	狐假虎威	狗仗人势	仗势欺人	藉
蹂躏	践踏	作践	鱼肉	残害	强奸	糟踏	动手动脚	施暴	轮奸
侮辱	污辱	辱	凌辱	折辱	糟蹋	糟践	侮慢
排挤	排斥	摈斥	倾轧	轧	党同伐异	挤兑	排外	互斥	挤掉
陷害	谗害	坑害	诬陷	构陷	诬赖	诬害	诬陷	坑	赖	冤枉	冤屈	罗织	深文周纳	嫁祸于人	以邻为壑
暗害	暗算	算计	计算	放暗箭	暗箭伤人	杀人不见血	谋害
下药	毒	鸩	鸩毒
乘人之危	趁火打劫	投井下石	落井下石	落井投石	打落水狗
危害	为害
勾结	勾搭	串通	勾通	通同	串	唱双簧	朋比为奸	狼狈为奸	拉拉扯扯	串通一气	沆瀣一气	同流合污	一鼻孔出气	勾连
帮凶	助桀为虐	为虎傅翼	为虎作伥	助纣为虐
挑拨	挑唆	调唆	调弄	播弄	鼓捣	捣鼓	离间	挑	挑拨离间	搬弄是非	间离
破坏	败坏	损坏	糟蹋
坏事	误事	帮倒忙	成事不足，败事有余
侵害	侵蚀	侵越	侵犯	犯
毒害	流毒	荼毒	蛊惑	麻醉
腐蚀	销蚀	风剥雨蚀	浸蚀
报仇	复仇	报仇	算账
公报私仇	官报私仇
报复	复	穿小鞋	以牙还牙	睚眦必报
回报	报	报恩
雪冤	申雪	昭雪
结伴	搭伴	搭伙	搭帮	结对
结伙	为伍	拉帮结派	结党营私	招降纳叛
拜盟	拜把子	结拜
结盟	同盟	联盟	歃血为盟	拉帮结伙	歃血结盟
断交	绝交	一刀两断
散伙	拆伙	作鸟兽散
生活	过活	过日子	吃饭	起居	饮食起居	衣食住行	安身立命	安家立业	度日	食宿
谋生	营生	求生	为生	糊口	度命	立身
居住	住	居	居留	栖身	安身	容身	卜居	存身	栖居	位居
群居	聚居	混居
小住	暂住	暂居	落脚
寄居	旅居	侨居	寄寓	寓居	作客	客居	流落
定居	安家	落户	安家落户
隐居	蛰居	蛰伏	幽居	隐	闭门谢客	归隐
住宿	歇宿	留宿	宿	借宿	投宿	寄宿	下榻	过夜	夜宿
露宿	露营
家居	闲居	赋闲	蹲
居无定所	东奔西跑	东奔西走	东跑西颠
风俗	乡规民约
停留	稽留	羁留	滞留	逗留	勾留	盘桓	栖息	停	待	留	闷	羁	栖	驻留
迁移	迁徙	搬迁	徙	迁	搬	动迁	外移
迁居	移居	乔迁	搬家	挪窝儿	喜迁
消磨	打发	虚度	泡	混	鬼混
度过	度	过	渡过	走过　
捱	熬	拖	度日如年	苦熬
虚度	蹉跎	虚度年华
经历	经验	阅历	涉世	阅世	更	阅	历	涉
亲历	躬逢
做寿	做生日	过生日
迎春	喜迎春
过节	逢年过节
独立	自立	独立自主	自主
自力更生	自食其力	自给自足	自给有余	自力
依附	仰人鼻息	看人眉睫	身不由己	俯仰由人	寄人篱下
受制于人	受人牵制	任人宰割
随大溜	随群	随俗	与时俯仰	与世浮沉	旅进旅退	人云亦云	随波逐流	随乡入乡
混日子	得过且过	做一天和尚撞一天钟
吃闲饭	吃现成饭	素食	素餐	尸位素餐	无所事事	吃现成
依托	依赖
流浪	流荡	漂泊	漂流	流转	飘零	乱离	流离颠沛	颠沛流离	流离失所	飘泊	飘流	四海为家	浪迹天涯	浮生	萍踪浪迹
流亡	逃亡	亡命	贲
投靠	投奔	投亲靠友
奔波	奔走	奔忙	跑	跑前跑后	奔波如梭	鞍马劳顿
走江湖	跑江湖	闯江湖	走南闯北	闯荡江湖
操劳	累	劳累
抽空	偷空	偷闲	忙里偷闲
发奋	奋发	奋勉	奋起	奋斗	奋	斗争	努力	艰苦奋斗	埋头苦干	奋起直追	奋发图强	发奋图强	发愤图强	励精图治	闻鸡起舞	拼搏	不可偏废	振兴图强	图强	奋发向上	奋争	创优	奋起拼搏	力拼	硬拼	勇攀高峰	懋	奋发努力	下工夫	劢	加把劲	加油	冲刺
自励	自勉	自强	自强不息	卧薪尝胆
争先创优	评先创优
荒废	荒疏	抛荒	荒	废	偏废
兴	振兴
偷懒	躲懒	怠惰	偷闲
避难就易	避重就轻
偷生	偷安	苟活	苟且	苟全	苟安	苟且偷生	苟全性命
过继	继嗣	承继
承继	继承	承受	承袭	袭	继	传承	代代相承
工作	干活儿	做事	行事	办事	视事	劳作	坐班	干活
上工	上班	出勤	出工
共事	同事
单干	唱独脚戏
从业	在业
劳动	劳	服务	劳务
突击	赶任务	开快车	加班	加班加点
怠工	磨洋工	消极怠工
打夜作	开夜车	挑灯夜战	夜战
跑腿儿	跑龙套	打杂儿	打杂	摸爬滚打
致富	脱贫致富
做	作	干	办	搞	打	弄	闹	为	行	将	来	抓	施	整	整治	动手	下手	抓挠	折腾	施行	打出	肇	自办	做做	力抓	勇为
办好	做好	搞好	善	搞活	盘活	抓好	善为
办成	办到
施展	施	耍	玩
露一手	牛刀小试	大显身手	大显神通	大展经纶	八仙过海，各显神通	小打小闹	小试锋芒	翻江倒海	大展宏图	有所为有所不为	有所不为而后可以有为	一试身手
合作	协作	搭档	搭伙	通力合作	经合	南南合作
尝试	试行	试	碰	摸索	跃跃欲试	试跳	小试牛刀	试试	试试看	搞搞	跃跃一试
试工	试办	试飞	试看
抱佛脚	临时抱佛脚	临渴掘井	临阵磨枪
放马后炮	贼去关门
赶浪头	赶时髦	赶潮流
留后路	留后手	留余地	留有余地	留底	留一手
留后患	养虎遗患	养痈遗患	放虎归山	后患无穷	纵虎归山	养痈成患
效劳	效力	出力	报效	投效	效命	效死	卖命	效忠	尽忠	尽职	尽责	鞠躬尽瘁	克尽职守	死而后已
造福	谋福利	造福一方
发扬	恢弘	伸张	扬	发扬光大	弘扬
增光	光大	光前裕后	光宗耀祖	增色添彩	增光添彩
增色	生色	生光
玷污	玷辱	辱没	污辱	辱	蝇粪点玉	亵渎
补救	弥补	挽救	亡羊补牢
挣扎	挣命	垂死挣扎	困兽犹斗
冒险	虎口拔牙	孤注一掷	铤而走险	龙口夺食
拼命	玩儿命	豁出去	拼死拼活
守节	节烈
守身	守身如玉
变节	失节
从事	务	事	业	从	操	行	从业	转产	转业	专事	专司	致力
厕身	侧身	存身	置身	投身	厕足
参加	加入	进入	投入	入伙	入	在	加盟
入席	就席	即席	就位	各就各位
混进	混入	混迹
脱离	脱	离	退	退伙	退出	淡出	洗脱	脱胶	剥离
退伍	退役
解脱	摆脱	超脱	脱出	出脱	开脱	脱身	抽身	蝉蜕	脱位
脱钩	脱节
出席	列席	参加	到	与	到场	在场	到会	与会	在座	到庭	赴会	到位	临场	在座
缺席	不到	缺阵
谋事	找事	求职	谋生路	谋职	求业
做工	做活儿	干活儿
扛长活	扛活	揽工
打短工	打短儿	打零工
务农	种田	种地	犁地	种粮	农务
经商	做生意	贾
跑码头	跑单帮
任教	执教
行医	从医
参军	从军	从戎	入伍	吃粮	服兵役	当兵	服役	现役	戎马	应征
投笔从戎	弃文就武
出家	削发	剃度	遁入空门
入行	出道
做官	从政	仕	宦
辞职	退职	告退	辞	卷铺盖	辞去	辞却
离职	去职	离任
引退	隐退	退隐	抽身	功成身退	解甲归田	急流勇退	功成引退
退休	离休	告老	告老还乡	退居二线	离退休
担负	担当	担待	承担	承当	承受	负担	负责	肩负	担	负	背	顶	当	荷	背负	承负	各负其责	顶住
承揽	兜揽	包揽	承包	包圆儿	揽	包	兜	三包	大包大揽	承修	包圆
担任	充任	出任	充当	任	充	当	做	常任	勇挑重担	担纲
胜任	独当一面	尽职尽责	不负
任职	供职
连任	连选连任
兼职	兼任	兼差	兼	一身两役	兼顾
采集	收集	搜集	征集	募集	采录	采访	采撷	采	集	募	编采	集萃	采采	撷	综采	集粹	收载	筹募
搜罗	收罗	网罗	罗致	招致
挑选	拣选	精选	甄选	提选	挑拣	选择	采择	抉择	摘取	选取	取舍	挑	选	拣	择	摘	卜	挑三拣四	披沙拣金	分选	慎选	增选	选项	挑挑拣拣	选料	选萃	求同求异	捎
选材	甄拔
择友	择交
抽样	取样
取长补短	截长补短	趋长避短	扬长避短	扬长补短	用长避短
观察	观测	察看	相	观	察	体察	考察	审察	洞察	着眼	察言观色	观赛
综观	通观	纵观	纵论
展望	瞻望	向前看
看破	看穿	看透	透视
比较	比拟	比	较	比起	较之	同比	相形之下	可比
对比	对照	对待	相比	比照	比	相对而言	相比之下	自查自纠	对立统一
区分	区别	分别	分	别	有别于	有别	界别	组别	工农差别
辨别	辨明	分辨	辨	识别	判别	甄别	鉴别	辨认	甄	辨识	识假	可辨
判断	断定	判定	论断	判明	判	认清	评断	一口咬定	咬定	看清
开门揖盗	引狼入室
使用	应用	利用	采用	施用	运用	行使	役使	使役	使唤	动用	运	用	以	使	动	下	祭	采取	用到
自用	私用
享用	受用
零用	零花
用于	用来	用以
沿用	套用	袭用	萧规曹随
因循	因袭	沿袭	承袭	蹈袭	陈陈相因	率由旧章
照搬	生搬硬套	生吞活剥
借鉴	引为鉴戒	引以为戒	用人之长	闻者足戒	以此为戒	引以为鉴	有鉴于	后车之鉴	以史为鉴
称	过秤	过磅	戥	磅	志	约	掂	称量	称称
量	计量	比量	计计
丈量	丈	步
计算	划算	盘算	筹算	匡算	合算	算计	约计	计量	乘除	计	算	匡	赀	精打细算	测算	汇算	算算	打算盘
核算	核计
换算	折算
掐算	能掐会算	妙算
运算	演算
合并	合	并	拼	融为一体	拼制	并线	集成	合二为一	一统	合二而一	融会	并轨	购并	三合一	并入	合龙	合拢	合一
凑合	拼凑	东拼西凑	七拼八凑	并拢	拼接
分开	划分	瓜分	分割	分	劈	分叉	细分	压分	私分	撩拨	剪切	撤并	区划	劈叉
平分	均分	平均	等分	四分开	分等
中分	平分秋色	一分为二	分片	分块
分摊	分担	分派	平摊	摊派	摊
分成	分为
出钱	出资	掏腰包	解囊	慷慨解囊	掏钱
筹集	凑份子
起床	起身	起来	下床
睡觉	睡	困	歇	安歇	上床	就寝	歇息	安息	寐	睡眠
小睡	打盹儿	打瞌睡	假寐	盹
午睡	歇晌
休息	休憩	歇息	喘息	停歇	喘气	休	歇	息	喘喘气	作息	歇歇
歇工	休工
乘凉	纳凉	歇凉	凉快	凉
疗养	将养	将息	休养	静养	养病	调护	调治	养	体疗
调养	保养	颐养	将养	养生	将息	调理	摄生	保健	消夏	安享	清心
补养	滋补	补	药补
理发	剃头	推头	整容
梳头	梳理	梳	拢	栉
烫发	烫头
刮脸	修面
打扮	装扮	妆饰	化妆	美容	美发
梳妆	梳洗	修饰
描眉	画眉	描眉画眼
整理	整	理	整治	拾掇	收拾	收束	摒挡	打点	疏理	盘整	重整	抉剔爬梳	规整
归拢	归着	归	理顺	归集
整装	治装
料理	张罗	经纪	操持	调停	调理	理
准备	预备	备	未雨绸缪	备而不用	有备而来	备选	以防不测	备灾
筹备	筹划	筹措	张罗	筹	制备	筹组
携带	随带	拖带	带	携	挈	牵	挟带	带走	带入	携家带口	捎
拉家带口	拖家带口
跟随	尾随	随从	跟	随	踵	从	追随	紧跟着	随行
赶集	赶场
外出	出外	出门	出远门	飞往	去往
出走	出奔	出亡
逃跑	逃走	逃脱	脱逃	逃遁	潜逃	逃逸	兔脱	逃匿	逃亡	亡命	逃	跑	遁	逸	奔	开小差	逃之夭夭	远走高飞	望风而逃	落荒而逃	临阵脱逃	金蝉脱壳	出逃	潜	潜流	乱跑	偷逃	虎口脱险	贲
溃逃	溃散
卷逃	席卷而逃
逃窜	窜逃	流窜	窜	抱头鼠窜	逃奔
溜走	溜号	溜	溜之大吉	溜之乎也
逃命	逃生
逃离	逃出
躲藏	隐藏	掩藏	潜藏	暗藏	隐匿	藏匿	逃匿	藏身	匿迹	敛迹	掩蔽	隐蔽	潜伏	埋伏	打埋伏	隐伏	匿伏	匿	伏	影	藏	躲	匿影藏形	隐没	隐身	东躲西藏	隐形
躲避	退避	畏避	闪避	闪躲	躲闪	闪	避
跟踪	盯梢	钉	跟	钉住	盯住
追踪	蹑踪	寻踪
寻找	找寻	寻觅	摸索	搜索	搜寻	追寻	物色	踅摸	寻	找	觅	索	搜	摸	按图索骥	查找	招来	追觅	查寻	搜求	探寻	找找	检索
翻箱倒柜	倾箱倒箧
储藏	贮藏	收藏	珍藏	保藏	藏	油藏	馆藏	归藏	窖藏	深藏	归藏	整存
坚壁	坚壁清野
储备	贮备	存贮	褚
储存	贮存	贮	积存	囤	囤积	仓储	存储	收储	专储	蕴藏
保存	封存	保留
归档	存档
库藏	库存
储蓄	储	存款	存	攒	联储	储贷
缝纫	缝	缀
绷	缉	缲	钉	缭	沿	吊	锁	絮
缝补	修补	织补	补	补缀	缝缝连连	补补	缝缝补补	修修补补
刺绣	绣花	扎花	绣	挑	挑花
滚边	沿边儿
纫针	穿针
晒	晾	曝	晾晒	曝晒
熨	烫	烙
点灯	掌灯	上灯	点火	明灯
烧火	点火	生火	笼火	打火	钻木取火	燃爆
点燃	燃点	点	燃	焚	生	放	引燃	燃放
烧化	焚化	火化
加热	烧	熬	炖	烫	暖	温	筛	热	加温
烘	焙	烘焙	炮	烙	焐
取暖	暖	悟	暖和
烧火	着火
烹饪	烹调	烹	烹制
掌勺儿	掌勺
做饭	起火	炊	下厨	煮饭
烹茶	泡茶
炒	煎	煸	炮	烹	做菜	小炒
炸	氽
烤	炕	燔	炙	烘制
煮	烧	咕嘟	熬	炖	焖	煨	烩	卧	扒	闷	熘
熬	馇	煲
氽	炝	涮	焯
蒸	烀
拔丝	拉丝
回锅	回炉	回笼	馏
品尝	品味	尝试	尝	品	咂	遍尝	尝尝
尝新	尝鲜
点饥	点心	点补	垫补
充饥	果腹
用餐	就餐	进餐	吃饭	进食	用	偏	用膳	开饭
下饭	佐餐
吃素	素餐	素食
吃荤	肉食	打牙祭
偏食	挑食
喂食	哺	喂
哺乳	喂奶	奶
会餐	聚餐
设宴	宴请	请客	飨客	大宴宾客	飨	接风洗尘
做东	作东
接风	洗尘
敬酒	劝酒
猜拳	划拳	打通关
展览	展出	展
欣赏	玩赏	观赏	赏鉴	鉴赏	赏玩	玩味	玩	赏	含英咀华	观瞻	赏析
游戏	游玩	游艺	游乐	娱乐	玩耍	戏耍	嬉戏	玩	耍	打	戏	好耍	玩乐	一日游	休闲游	纪游	玩玩	娱	怡然自乐	嬉水	打闹	嬉	逗逗乐乐	自乐
捉迷藏	藏猫儿
猜谜儿	破谜儿	猜谜
游览	游历	巡礼	登临	巡游	旅游	出游	云游	漫游	畅游	游山玩水	遨游	周游	环游	出境游	国旅	观光
郊游	踏青	春游	野营	游园	城乡游	三峡游
消遣	清闲	排遣	自遣	排解	解闷	散闷	散心	消	消闲
游荡	游逛	闲逛	闲荡	逛荡	转悠	逛	游	逛逛	敖
行乐	取乐	作乐	寻欢作乐	声色犬马
抽签	抓阄儿	拈阄儿
恋爱	相恋	谈恋爱	谈情说爱	婚恋
钟情	一见钟情
追求	求偶	追	言情
求婚	求亲	提亲
调情	吊膀子
偷情	偷香窃玉	窃玉偷香
约会	幽会	幽期	花前月下
订婚	定婚	定亲	攀亲	受聘
许配	许	配	字
结婚	婚	成婚	婚配	完婚	成亲	安家	成家	结合	拜天地	办喜事	洞房花烛	喜结连理
新婚	新婚燕尔
联姻	缔姻	通婚	结亲	换亲	匹配	喜结良缘	男婚女嫁
娶	娶亲	讨亲	迎娶
续弦	纳妾
嫁	出嫁	嫁人	出阁	出门子	过门	聘	妻	嫁娶
改嫁	转嫁
再嫁	再婚
入赘	上门	招女婿	招亲	招赘	赘	倒插门
离婚	离异	离
退婚	退亲
自杀	自尽	寻死	作死	自戕	自裁	轻生	自寻短见	寻短见	自决	自绝
自刎	抹脖子	刎
上吊	吊死	悬梁	自缢
投河	投井
治丧	丧葬	办丧事
吊丧	吊孝	吊唁	奔丧
大殓	装殓	入殓	收殓	殡殓	殓
出殡	殡葬	发送
送殡	送丧	送葬	执绋
安葬	埋葬	下葬	土葬	入土	入土为安
火葬	火化
海葬	水葬
陪葬	殉葬	殉	随葬
戴孝	穿孝	带孝
扫墓	上坟	祭扫
瞻仰	参谒	参见	拜谒	谒	飨
祭祀	祭	祀	祝福	祭天	祭拜	腊
祭奠	祭	奠
生事	闹事	惹事	肇事	滋事	启衅	捣乱	捣蛋	点火	放火	作怪	作恶	闹鬼	找麻烦	惹是生非	无事生非	造谣生事	无理取闹	小丑跳梁	群魔乱舞	兴妖作怪	为非作歹	无所不为	兴风作浪	掀风鼓浪	唯恐天下不乱	招事	撒野	扰民	惹麻烦	惹事生非	添乱	作乱	作祟
蠢动	蠢蠢欲动
挑衅	寻衅	找上门	衅寻滋事
胡闹	胡来	胡搅	乱来	胡搅蛮缠	造孽
肆行	胡作非为	胆大妄为	肆无忌惮
捏造	编造	假造	捏合	杜撰	虚构	编	造	无中生有	胡编
冒充	假冒	假充	混充	作假	作伪	冒牌	冒	顶	充	以假乱真	鱼目混珠	挂羊头卖狗肉	打肿脸充胖子	伪造	充数	滥竽充数	冒用	制假	售假	卖假	冒领	以假充真	贩假	仿冒	冒顶
冒名	假托	伪托	假借	僭	冒名顶替	假公济私	借此	盗名欺世	矫
沽名钓誉	欺世盗名	欺世惑众
炫耀	夸耀	显耀	炫示	显示	显露	显摆	摆	炫	自诩	咋呼	搬弄	表现	标榜	自我标榜	出风头	招摇过市	卖弄	诩	抖威风	大出风头	谝
邀功	邀功请赏
摆阔	摆摊子	摆阔气
摆门面	摆样子	装门面	装潢门面	摆谱	耍排场
撑场面	撑门面
摆架子	拿架子	搭架子
逞能	逞强	逞英雄	逞
卖乖	卖弄聪明	自作聪明
班门弄斧	布鼓雷门
逞性	任性	任意	使性子	耍脾气	闹脾气
感情用事	意气用事
拾荒	捡破烂儿
乞讨	讨乞	行乞	要饭	讨饭	乞食	乞	讨
上来	上去	上
蜂拥而上	一哄而上	一拥而上
下去	下来	下
来	来到	到来	过来	到	莅	至	临	来临	驶来	赶到	赶来
莅临	降临	惠临	光临	驾临	贲临	亲临	光顾	惠顾	屈驾	慕名而来	不期而至	翩然而至	乘兴而来	远道而来	随之而来
接踵而来	源源而来	纷至沓来	蜂拥而来	接踵而至
去	过去	往	奔	前往	前去	造	之	赴	通往	徊	转赴	踅
开往	开赴	奔赴	赶赴	赶往
一怒而去	拂袖而去	拂衣而去
来去	来回	来往	过往	往返	往复	往来	来来往往	老死不相往来	来回来去	回返
出	出来	出去	下	沁
进	进入	进来	进去	上	登	入	跻身
流入	流	注入	渐	渗
升堂入室	登堂入室
出入	进出
进出境	入出境
弄错	失误	疏失	出错	离谱	错	拧	串	差	一差二错	阴错阳差	阴差阳错	铸成大错
失言	失口	走嘴	说走嘴
鲁鱼亥豕	鲁鱼帝虎
点金成铁	画蛇添足	画虎类狗
失职	渎职	玩忽职守
犯规	犯禁	违禁	违章
混淆	搅混	搅乱	淆乱	模糊	歪曲	张冠李戴	指鹿为马	混淆是非	混淆黑白	习非成是	混为一谈	混淆视听
澄清	弄清	正本清源	辟谣	澄	搞清	疏淤	清淤
颠倒	颠倒是非	颠倒黑白	倒果为因	本末倒置	舍本逐末	轻重倒置	明珠投暗	剖腹藏珠	舛
反客为主	喧宾夺主
篡改	歪曲	曲解
改正	纠正	纠	正	改	拨乱反正
纠偏	补偏救弊	矫正
改过	悔过	改悔	回头	改过自新	悔过自新	改邪归正	弃邪归正	弃暗投明	弃旧图新	痛改前非	脱胎换骨	洗心革面	翻然悔悟	知过必改	洗手不干	迷途知返	败子回头	回头是岸	今是昨非	改过迁善	纠章	自纠	力矫	自查自纠
真假	真伪	真真假假
前进	迈进	进	上	向前	进发	迈入	前行	一往直前	无止境	永往直前	上前
乘风破浪	长风破浪	破浪前进
阔步前进	昂首阔步
并进	齐头并进
后退	退	退回	退走	退却	却步	倒退	退缩	退避三舍	打退堂鼓	退后
追赶	追逐	追逼	尾追	追	赶	撵	你追我赶	迎头赶上	赶超	赶上	急起直追	穷追	竞逐
祷告	祈祷	祷	弥撒	弥散	祈愿	祈福
礼拜	顶礼膜拜
跪拜	礼拜
祝福	赐福
朝觐	朝圣	巡礼	朝拜
拜佛	敬奉	供奉
烧香	焚香
斋戒	吃斋	斋
念经	诵经	念佛	讲经说法
修行	修道	苦行	尊神
传教	传道	布道	说教	说法
募化	化缘	化
布施	施舍	施	舍	斋	嗟来之食
炼丹	点化
测字	拆字
看相	相面
圆梦	占梦
占卜	占	卜	筮
占卦	算卦	卜卦
打醮	醮
保佑	庇佑	呵护	荫庇	佑
检举	揭发	告发	告密	报案	举报
弹劾	参
控告	告状	指控	控	告	状告	控诉
上告	上诉
喊冤	叫屈	申冤	申雪	喊冤叫屈	抗诉
诬告	诬
诉讼	词讼	打官司	讼	辞讼
自首	投案
招认	供认	认罪	供认不讳	交待
招供	自供	坦白	供	招	交代	不打自招	松口
搜查	抄家	搜	抄	查抄
搜身	抄身
拘留	羁留	扣留	羁押	收押	拘禁	拘押	扣押	关押	看押	管押	在押	羁押	扣	看	押	圈	絷	禁闭	关禁闭	吊扣	扣压
囚禁	监禁	幽禁	幽闭	收监	禁锢	囚	幽	被囚	监缴	身处牢笼
软禁	幽禁	幽闭
劳改	劳动改造	劳教
逮捕	拘捕	缉捕	搜捕	追捕	捉拿	捉住	捕拿	缉拿	通缉	拘	抓	逮	捉	捕	缉	办案	逋	抓捕	拘役	查扣	围捕	拘传	批捕
拿获	捕获	缉获	破获	一网打尽	抓获	抓走	擒获
押送	解送	押解	押	解	扭送	密押
释放	开释	假释	保释	获释	自由	释	放	纵	出狱	放出	刑满释放	放活	放走	放飞	刑释解教
审讯	审问	讯问	鞫问	鞫讯	问案	审案	审	讯	鞫	升堂
复审	再审
审理	审判	断案	判案
提审	传讯
开庭	过堂
刑讯	拷问	打问	逼供	屈打成招
判决	裁判	裁定	裁决	裁断	宣判	公判
判罪	论罪	坐	定罪	判处	判刑
定案	定责
量刑	处刑
惩办	法办	查办	究办	惩处	惩治	惩罚	处治	处置	发落	治罪	收拾	惩治	办	处	绳之以法	绳之以党纪国法	处以
严惩	重办	严惩不贷
惩戒	惩前毖后	惩一警百	杀一儆百	杀鸡吓猴	以一警百	惩一儆百
上刑	动刑	用刑	严刑	拷打
凌迟	剐
车裂	五马分尸
支解	磔
灭族	夷族	族	株连九族
没收	充公	抄没	罚没
查封	封闭	封	封门
剥夺	褫夺	夺	禁用
游街	示众
充军	发配	刺配	流放	放逐	放	配	流	下放	放流
偿命	抵命
处决	正法	行刑	镇压	杀	明正典刑	临刑	处死
枪毙	枪决	毙	崩	毙伤
斩首	杀头	开刀
赦免	大赦	特赦	赦	贳
免罪	免刑	免责
违法	犯法	犯罪	犯案	作案	不轨	作奸犯科	违法乱纪	以身试法	违纪	图谋不轨	冒天下之大不韪	玩火
枉法	贪赃枉法	徇私枉法	有法不依
知法犯法	执法犯法	明知故犯
放火	纵火
绑架	绑票	架	劫持
持机	劫机
抢劫	打劫	行劫	劫掠	抢掠	抢夺	掠夺	劫夺	攘夺	掳掠	掠取	攫取	抢	掠	劫	夺	掳	打家劫舍	杀人越货	夺走	争抢	抢走	拼抢	强取豪夺
路劫	断路
洗劫	洗劫一空	哄抢	一抢而空	劫掠一空
趁火打劫	趁人之危
盗窃	偷窃	行窃	偷盗	偷	盗	窃	顺手牵羊	小偷小摸	监守自盗	扒窃	盗伐	盗打	盗掘	盗取	盗走	窃走	偷走
鼠窃狗偷	偷鸡摸狗
窝赃	窝藏
分赃	坐地分赃
杀死	杀	诛	殛	结果	剌	干掉	弑
杀害	凶杀	行凶	灭口	残杀	残害	下毒手	杀人越货
活埋	坑
下毒	放毒	毒杀
自相残杀	自相残害	自相鱼肉
暗杀	刺杀	行刺	刺	干
屠杀	杀戮	屠戮	屠	血洗	劈杀	大屠杀
狎妓	嫖妓	嫖娼	嫖	逛窑子	寻花问柳	拈花惹草	偷香窃玉	窃玉偷香	问柳寻花
卖淫	卖身	招蜂引蝶
通奸	私通	姘居	同居	苟合	奸	通	偷人
奸污	奸淫	强奸	诱奸	鸡奸	奸
调戏	玩弄	猥亵
赌博	赌钱	耍钱	赌	博
压	压宝	投注
抽头	打头
钻营	钻谋	运动	活动	走内线	走后门	钻门子	蝇营狗苟	上供
贿赂	行贿	贿买	打点	收买	买通	贿金	贿	公贿	贿选	赂
受贿	纳贿	贪赃	贪赃枉法	中饱私囊	受惠
舞弊	作弊	做手脚	营私舞弊	徇私舞弊	上下其手	营私
徇私	徇情	开后门	以权谋私	放水	猫儿腻
剽窃	剽取	抄袭	剿袭	抄	依葫芦画瓢
侵吞	吞没	侵占	强占	抢占	侵夺	并吞	鹊巢鸠占	巧取豪夺
克扣	揩油
敲诈	讹	诈	勒索	敲	讹	敲竹杠	敲诈勒索	讹诈
打秋风	秋风	抽风	坑蒙拐骗
拐骗	拐带	诱拐	拐	坑骗
诈骗	诈	行骗	骗
剥削	盘剥	敲骨吸髓	宰客
搜刮	搜括	压榨	榨取	敛财	聚敛	刮	搂	刮地皮	横征暴敛	压迫
投机	投机倒把	买空卖空
浑水摸鱼	捞
囤积	囤	囤积居奇
走私	走漏	走私贩私
天亮	发亮	拂晓	破晓	天明	亮	旭日东升
日上三竿	晴好
天暗	天黑	夜幕低垂	迟暮
夕阳西下	日薄西山
晴	晴朗	明朗	清朗	爽朗	清明	晴和	晴空万里	万里无云	光风霁月	晴天	天高气爽	响晴	月明风清	晴到少云	阴转多云
风和日暖	风和日丽	春光明媚
放晴	霁	雨过天晴	云开日出	云消雾散
阴	阴暗	阴沉	阴沉沉	阴霾	霭霭	密云不雨	天昏地暗	阴天	阴间多云	晴到多云
刮风	起风
拂面	扑面	习习
萧萧	萧瑟	春风料峭
狂风怒号	飞砂走石	山雨欲来风满楼	飞沙走石
下雨	降雨	降水	掉点儿	天公不作美	天不作美	普降
滂沱	霈	大雨如注
风狂雨骤	暴风骤雨
风雨交加	风雨如磐	风风雨雨	风雨凄凄	凄风苦雨
雨天	下雨天
下雪	大雪纷飞	降雪
风雪交加	风雪
降霜	霜降
打闪	闪电
打雷	霹雳	雷鸣	雷电交加	雷轰电闪	雷鸣电闪	雷电
起雾	雾蒙蒙	雾气腾腾	雾腾腾
冒烟	浓烟滚滚	烟雾弥漫
起浪	波涛汹涌	波涛滚滚	惊涛骇浪	洪流滚滚	波涛滚滚	汹涌澎湃	怒涛澎湃
照射	投射	映射	映照	照耀	炫耀	照临	辉映	照	射	耀	投
照亮	照明	烛照	烛	生辉
光照	普照	日照
反射	反照	照	映	反光	相映成辉	倒映
辐照	辐射
交相辉映	晖映
照见	映出
折光	折射
发光	发亮	煜
闪光	闪亮	闪烁	闪耀	忽闪	烁烁	忽明忽暗	熠熠闪闪	闪烁生辉	光闪闪
金光闪闪	金闪闪
作响	响	鸣	作	呜咽	响起	叮当	鼓乐齐鸣
轰	轰鸣	吼	号	呼啸	啸鸣	咆哮	巨响
爆炸	爆裂	放炮	炸
炸毁	炸裂	炸掉
核爆炸	核爆
燃烧	焚烧	燃	烧	燔	焚	着	灼
烧毁	焚毁	付之一炬
焦	燎	煳
沸腾	开锅	开	沸	滚	喧	滚沸
蒸发	挥发	跑	飞	走	乱跑
溶解	溶化	溶
融化	溶化	融解	融	消融	化	烊	融注	化入	溶入	溶溶
冷却	冷	凉	激	镇	制冷	降温	气冷
结冰	冻结	上冻	冰冻	冻	冷凝	封冻	凝冻	冷冻
解冻	化冻	开河	开化	开
腐烂	腐败	腐化	腐朽	烂	朽	败	腐	糜烂	朽烂
发霉	霉	霉烂	酡
变质	馊	坏
生锈	锈
褪色	落色	脱色	掉色	走色	退色
生育	生产	生养	生	产	养	生儿育女	添丁
孪生	双生
足月	待产
分娩	分身	临盆	临产	分蘖
坐月子	坐蓐
流产	小产
生于	出生于
诞生	出生	降生	生	落地	坠地	出世	落草
生长	见长	生	长	发育
成长	长进	成人	成材	成才
出挑	出脱	出落	出息
长成	长大
繁殖	生殖	殖	滋生	生息	蕃息	繁衍	传宗接代	增殖
下	生	产	产卵	下蛋
孵	抱	抱窝	孵化	孵卵	孚
发胖	发福
活	生	生活	生存	在世	健在	存	在	活着
回生	生还
死	亡	故	卒	弱	逝	殁	殪	毙	殂	殒	薨	死亡	亡故	身故	物故	物化	去世	逝世	故世	谢世	弃世	过世	下世	凋谢	毙命	殒命	殒灭	殂谢	长逝	永诀	永别	长眠	故去	断气	咽气	合眼	闭眼	完蛋	呜呼	回老家	玩儿完	翘辫子	上西天	粉身碎骨	与世长辞	溘然长逝	寿终正寝	命赴黄泉	呜呼哀哉	一命呜呼	死去	气绝身亡	辞世	已故	碎骨粉身	撒手人寰
仙逝	千古	作古	归西	归天	过去	不讳	跨鹤西游	三长两短	山高水低	病故	病逝
牺牲	舍身	献身	就义	捐躯	殉职	殉国	殉难	殉节	殉	效死	效命	授命	阵亡	杀身成仁	舍生取义	马革裹尸	肝脑涂地	为国捐躯	以身殉职	死而后己	自我牺牲	成仁	舍死忘生
横死	凶死	丧命	送命	毙命	暴卒	死于非命	没命	丧生	身亡	丧身
升天	坐化	羽化	物化	圆寂
夭折	夭亡	早逝	殇	兰摧玉折	夭	英年早逝
半死	濒死	一息尚存
醒	睡醒	苏醒	清醒	觉	寤	苏	醒来	复明
入睡	入梦	入眠	成眠	安眠	睡着	着	入梦乡
沉睡	熟睡	睡熟	鼾睡	酣睡	酣梦	酣然
休眠	眠	蛰伏
瞌睡	打盹
失眠	辗转反侧	目不交睫	夜不能寐	寝不安席
饱	打饱嗝儿
饿	饥	馁	饥饿	挨饿	饿饭	食不果腹	饥肠辘辘	嗷嗷待哺	喝西北风
渴	干	焦渴	干渴	舌敝唇焦	口渴
馋	嘴馋	贪嘴	贪吃	饕	饕餮	馋涎欲滴	垂涎欲滴
醉	醺
酩酊	醉醺醺	酩酊大醉	烂醉如泥
打嗝儿	嗳气	呃逆	饱嗝儿	呃	嗝儿
喷嚏	嚏喷
打呵欠	打哈欠	哈欠	呵欠	微醺
大便	大解	拉屎	出恭
便秘	下泄
小便	小解	撒尿	起夜	排泄	泌尿
尿床	尿炕	遗尿
癃	闭	癃
解手	净手	更衣	便溺	屙	拆	大小便	上解
出汗	流汗	淌汗	挥汗	汗津津	汗流浃背	挥汗如雨	满头大汗	冒汗	大汗淋漓
盗汗	出冷汗
行经	来潮	便血
性交	交媾	云雨	同房	人道	行房
交配	交尾	配对	杂交
遗精	梦遗
怀孕	怀胎	有喜	妊娠	有身子	大肚子	身怀六甲	孕
受孕	受胎	受精
生病	害病	有病	闹病	患病	得病	受病	染病	抱病	扶病	卧病	病	害	患	病倒	患有	久病	身患	致病	带病	病魔缠身	年老多病
不适	不快	难受	难过	不爽	不得劲	沉	无碍
犯病	发病	犯节气
欠安	不安
病重	病笃
病危	危笃	危重	危殆	弥留	病入膏肓	气息奄奄	奄奄一息	行将就木	命在旦夕	朝不保夕	凶多吉少	九死一生	万死一生
垂死	垂危	濒危	临危	临终
受伤	负伤	挂花	挂彩
遍体鳞伤	体无完肤	皮开肉绽	重伤
扭	蹩	闪	崴
烧伤	灼伤	烧灼
伤亡	死伤
杀伤	刺伤
病愈	痊愈	大好	康复	起床	霍然	愈	痊	好	药到病除	治愈
好转	见好	有起色	回春
收口	合口	愈合	伤愈
复活	还魂	复生	起死回生	死而复生
痒	痒痒	刺痒	刺挠	瘙痒	发痒
酸	酸软	酸溜溜
痛	疼	疼痛	火辣辣	生疼	触痛	作痛	隐隐作痛
心绞痛	狭心症
肿	膀	浮肿	水肿	肿大
胀	发胀	肿胀	鼓胀	水臌	气臌	头昏脑胀	腹胀	滞胀
食积	存食
消化	克	化
咳	咳嗽	干咳
吐	呕吐	哕	呕	吣
孕吐	害喜	胎气
吐血	呕血	咯血
泻	腹泻	水泻	拉稀	泻肚	跑肚	闹肚子	拉肚子	下泻
着凉	受凉	伤风	着风	感冒	受寒
受暑	受热	发痧
发烧	发热	发寒热	烧	发高烧
高烧	高热
头昏	昏	晕	昏乱	昏沉	昏眩	头晕	眩晕	迷糊	晕乎乎	昏头昏脑	昏天黑地	晕头晕脑	晕头转向	天旋地转	眼冒金星	腾云驾雾	发昏	发懵	头晕眼花	头晕目眩
昏沉沉	昏昏沉沉
眼花	昏花	目眩	雾里看花	看朱成碧	头昏眼花
休克	虚脱	窒息
昏迷	昏倒	晕倒	昏厥	晕厥	痰厥	蒙	不省人事	昏迷不醒
谵妄	说胡话
抽搐	抽搦	搐缩	抽缩	抽风	抽筋	抽	转筋	痉挛	搐搦
麻木	发麻	酥麻	不仁	麻痹	麻	木	麻酥酥	麻木不仁
瘫痪	风瘫	瘫	截瘫	偏瘫	半身不遂	脑瘫
单瘫	下痿	瘛
发疯	发狂	疯癫	癫狂	疯狂	疯	狂	痴	癫	发神经	神经错乱	疯颠颠	疯了呱几
心悸	心跳	怔忡	惊悸
贫血	血亏
梗塞	栓塞	堵塞	哽	壅塞
肠梗阻	肠阻塞	肠套叠
出血	衄	血崩	崩漏	血流如注	流血	大出血
化脓	溃烂	溃
哑	喑	喑哑	沙哑	倒	失音	倒嗓	嘶哑
聋	背	聩	耳背	失聪	重听	耳沉
瞎	失明	盲	眇	瞎眼
口吃	结巴	磕巴	謇	期期艾艾
驼	驼背	佝偻	水蛇腰	偻
跛	瘸	拐	蹇	跛足
开花	开放	绽	开	放	吐蕊	绽出	争芳斗艳	百卉吐艳	群芳争艳	绽开	绽放	里外开花	怒放	盛开
结果	结实	结出	结荚
凋谢	萎谢	凋落	凋零	零落	衰落	衰败	枯萎	枯槁	萎缩	萎蔫	蔫	谢	凋	败	枯	萎靡
吐穗	抽穗	秀	孕穗	打苞
受粉	受精
发芽	抽芽	出芽	滋芽	萌芽	萌动	萌发	吐绿	萌
成熟	熟	稔	秋
笑	乐	欢笑	笑笑
大笑	绝倒	喷饭	哄笑	狂笑	噱	哈哈大笑	仰天大笑	前仰后合	捧腹大笑	哄堂大笑	哄然大笑	大笑不止	开怀大笑	欲笑无声
微笑	莞尔	哂	粲然一笑	嫣然一笑	眉欢眼笑	满面笑容	面带微笑
发笑	失笑	忍俊不禁
苦笑	干笑	强颜欢笑
暗笑	窃笑
奸笑	皮笑肉不笑	笑里藏刀
谄笑	胁肩谄笑
憨笑	傻笑	傻乐	哂笑
笑哈哈	笑呵呵	笑眯眯	笑嘻嘻	笑盈盈	笑吟吟
嬉皮笑脸	嘻嘻哈哈	嬉笑
含笑	笑容满面	笑容可掬	眉开眼笑	喜眉笑眼	笑逐颜开
哭	啼哭	啼	哭鼻子	哭哭啼啼	哭丧着脸
号	号哭	呼号	哀号	声泪俱下	号啕大哭	痛哭流涕	呼天抢地	哭天哭地	哭天抹泪	如丧考妣	啼饥号寒	鬼哭神嚎	鬼哭狼嚎	哭喊	哭叫	哀呼	哭丧	如诉如泣	抱头痛哭	如泣如诉
泣	哭泣	饮泣	啜泣	涕泣	抽泣	抽噎	抽搭	哽咽	幽咽	呜咽	吞声	饮泣吞声	悲泣	盈眶
流泪	挥泪	洒泪	涕零	声泪俱下	落泪	潸然泪下
泪如泉涌	泪如雨下	以泪洗面	泪痕斑斑	老泪横流	老泪纵横	泪流满面	痛哭
含泪	泪汪汪	珠泪盈眶	热泪夺眶	热泪盈眶
害臊	害羞	含羞	怕羞	腼腆	羞人	羞涩	羞怯	娇羞	羞	臊	忸怩	抹不开	羞答答	羞人答答	羞羞答答	不好意思
红脸	脸红	红潮	赧颜	赧然	面红耳赤	脸皮薄
没羞	不害羞	脸皮厚	好意思	涎着脸	老着脸皮	死皮赖脸	涎皮赖脸	死乞白赖	恬不知耻	不知人间有羞耻事
卖俏	搔头弄姿
传情	眉目传情	脉脉传情	眉来眼去	暗送秋波
撒娇	发嗲	扭捏
娇滴滴	嗲声嗲气	娇里娇气
叹气	叹息	太息	嗟叹	兴叹	叹	嘘	唉声叹气	长吁短叹	咳声叹气
长叹	浩叹	仰天长叹
悲叹	哀叹
慨叹	喟叹	感慨	感叹	慨然	感慨万端	感慨不已	感慨万千	感慨万分
发呆	发愣	愣神儿	出神	木然	傻眼	呆	愣	眼睁睁	直勾勾	干瞪眼	呆若木鸡	泥塑木雕	木雕泥塑	张口结舌	瞠目结舌	目瞪口呆	直眉瞪眼	发楞	发傻	愣住	愣神	缄口结舌
沉默	默然	静默	缄默	默	默默无言	默默不语	默不作声	沉默寡言
不做声	闷头儿	缄口	绝口	不声不响	不言不语	不哼不哈	闭口无言	哑口无言	一言不发	一声不响	不赞一词	欲言又止	三缄其口	噤若寒蝉	无言以对
振奋	振作	抖擞	饱满	旺盛	充沛	焕发	风发	奋发	上劲	来劲	起劲	带劲	神气	精神	精神百倍	神采奕奕	生龙活虎	生气勃勃	朝气蓬勃	鼓足	动感	群情激奋	精精神神
激发	鼓	抖	打	激
激昂	激扬	昂扬	高昂	昂然	昂昂	慷慨激昂	激昂慷慨	拍案而起	壮志凌云	意气风发	有神	精神抖擞	精神焕发	容光焕发	神采飞扬	雄赳赳	气昂昂	壮怀激烈	斗志昂扬
疲倦	疲劳	疲乏	倦	疲	乏	懒	累	困	困乏	困顿	困倦	劳累	疲惫	困惫	慵懒	疲顿	委顿	疲竭	疲软	精疲力尽	惫	劳乏	累人	闷倦	乏力	瘁	嗜睡	累死	忧困	虚弱不堪	疲弱	疲态
风尘仆仆	仆仆风尘	人困马乏	疲惫不堪	精疲力竭	力尽筋疲	声嘶力竭
懒散	恹恹	蔫	蔫不唧	懒洋洋	没精打采	有气无力	精神不振	软弱无力
颓唐	萎靡不振	垂头丧气	暮气沉沉	死气沉沉	死沉	蔫头耷脑
板脸	绷脸
瞪眼	怒目	横眉怒目
喘息	气短	气急	气咻咻	气吁吁	气喘吁吁	上气不接下气	喘嘘嘘	喘喘气
气喘	哮喘	喘气	喘	痰喘
屏气	屏息	屏
假装	伪装	装作	作伪	装假	假充	佯装	装	作	佯	诈	弄虚作假	装做
做作	扭捏	装蒜	装腔	装相	装样子	装腔作势	装模作样	惺惺作态	东施效颦	故作姿态	拿腔作势	拿腔拿调	矫揉造作	无病呻吟	一本正经	假模假式	捏腔拿调	虚饰	娇揉造作
装傻	装疯卖傻	装糊涂
假死	佯死	诈死	装死	装熊
翘	跷	企	抬	昂	仰	撅
悬	荡
垂	下垂	低垂	低下	放下	坠	俯	拖	耷拉	悬垂
披	披散
凸起	隆起	突起	突出	鼓起	崛起	暴	鼓鼓的	鼓鼓
凹陷	陷	陷落	塌陷	穹形
裸露	赤露	袒露	曝露	袒	露	赤	光	光溜溜	敞露	外露	裸	赤裸	赤身露体	露出
裸体	赤裸裸	赤条条	精光	赤身裸体	一丝不挂
赤膊	赤背	打赤膊
赤脚	赤足	打赤脚	科头跣足
遮盖	掩盖	覆盖	被覆	盖	覆	蒙	挂	罩	埋	掩	蔽	蒙面	遮住	披盖	庇	遮荫	幂
遮挡	遮蔽	障蔽	荫蔽	屏蔽	遮藏	遮掩	荫	遮	挡	翳	挡住	挡风遮雨	遮风挡雨	遮光
笼罩	笼
伸	引	延	伸进	奋翅展翼
展	伸展	展开	张	铺展	舒展	舒张	张大	拓
直	挺直	伸直	梗
挺	腆
缩	收缩	收拢
蜷缩	挛缩	瑟缩	龟缩
伸缩	舒卷
张合	翕张
落下	落	掉	掉落	堕	跌	跌落	坠落	跌入	坠入	倒掉	一泻而下	花落花开	打落
倒塌	坍塌	塌架	崩塌	倾倒	倒下	倾覆	坍	塌	垮	倾	圮	溃
塌方	坍方
天塌地陷	天坍地陷
损坏	弄坏	破坏	毁坏	毁损	毁伤	坏	毁	摔	磨损	毁掉
裂开	裂	分裂	破裂	开绽	龟裂	裂缝	裂口	坼	绷	豁	绽	披	皴	绽裂	开裂	踏破	皴裂	冻裂	崖崩	皲裂	干裂	颚裂
爆裂	迸裂	崩裂	崩	炸	爆	炸掉
折断	断裂	断	折
耸立	矗立	壁立	陡立	挺立	屹立	独立	直立	矗	峙	耸	屹	坚挺	高矗
停放	放置	停	放
寄放	存放	寄存	存	存放在
悬挂	吊	挂	悬	吊放	浮吊	高悬	悬垂	挂到	昂立	吊起
颠倒	倒
陈列	陈放	罗列	摆	陈	位列	列支	班列
布置	陈设	摆设	摆布	摆	张	摆放	布阵
排列	排	列	平列
列为	名列	排定
分布	散布	布	遍布
堆积	堆	积	积聚	堆放	堆积如山
淤积	沉积	冲积	淤	淤积物
散落	洒	撒	落	天女散花
浇	淋	浞	打	浇水	沐
溅	迸	澎	飞溅	迸射
喷	喷射	喷溅	喷发	射	唧	滋	迸发	高射	喷洒	喷涂	喷涌
溢	漫	漾	漫溢	泛滥	溢出	涌	浩	滔
滴	沥	淋漓	滴答	滴滴答答
泡	浸	浸泡	浸渍	浸入
淹	淹没	灭顶	溺水
沉	没	下沉	击沉	沉底	下移	降下	下浮
陷	下陷	沉陷	沉陷	沉没	陷落	沉淀	沉井	没顶	陷没
漂	浮	泛	氽	浮动	浮泛	漂浮	悬浮	漂流	漂移	飘荡	飘忽	浮游	飘浮	上浮
磁悬浮	磁浮
流	流动	流淌	淌	注	横流	绿水长流
奔泻	倾泻	奔流	涌流	泻	倾注	奔涌	泽泻	涌动	流下	一泻而下	流泻
潺潺	涓涓
翻腾	翻滚	滚滚	沸腾	滕	滔天
飘	飘扬	飘洒	飘荡	浮荡	回荡	飘摇	飘然	飘舞	飞舞	飘忽	招展	飞扬	袅袅	依依	飘动	飘拂	飘落	飘飘扬扬	彩蝶飞舞	翩翩飞舞	扬尘	高扬	飘飘	飘曳
移动	运动	活动	挪动	位移	挪	动	走	倒	移位	举手投足	挪窝	平移	移步
滑动	滑行	滑	滑跑
等速运动	匀速运动
简谐运动	谐振
动弹	动作
跳动	扑腾	跳	双人跳
摇摆	摇晃	摇动	摇荡	摇曳	摆动	晃动	晃荡	晃悠	悠荡	晃	悠	忽悠	摇摇晃晃	半瓶子晃荡	深一脚浅一脚	颤巍巍	颤悠
颤动	抖动	颠簸	颠	震	簸荡	震荡	振荡	振动	震动	共振
旋转	打转	转动	转悠	旋	转	盘	兜	团团转	筋斗	蟠	跟斗	旋动	漩起	打转儿	大回转
运转	运行	运作	周转
盘旋	回旋	萦回	回绕	打圈子	兜圈子	绕圈子	连轴转	转来转去	转圈	转体
缭绕	旋绕	萦绕	萦回	盘曲	回环	回	弯弯
滚动	骨碌	滚	滴溜溜转	一骨碌	轮转
掉转	扭转	回转	反过来	扭	回	拨	转	掉	磨	翻转	扭动	扭曲	转过	转头
转身	回身
弯转	弯	曲	屈
润泽	滋润	润滑	润
刺激	刺	烟	辣	薰	杀	咬	淹	条件刺激	呛	剌
撞	击	拍	碰	磕	打	撞击	冲击	冲撞	磕碰	相撞	相碰	碰撞	硬碰硬	撞倒	磕磕碰碰	碰上	碰碰	猛击	横冲直闯	惊涛拍岸
触	碰	沾	点	硌	接触	沾手	触及	触发
着	巴
相遇	遇	撞	逢	相逢	遇到	碰到	遇见	撞见	碰见	相见	打照面	碰面	遇上	赶上	欣逢
狭路相逢	冤家路窄	狭路相遇
巧遇	偶遇	邂逅	不期而遇	萍水相逢	邂逅相逢
重逢	久别重逢	旧雨重逢
错过	相左	失之交臂	交臂失之	擦肩而过
摩擦	磨蹭	磨	擦	蹭	错	掠	拂	摩	吹拂	磨光	抗磨
附着	黏附	依附	嘎巴	沾	巴	蹭	沾满	屈居	附上
畅通	通畅	畅达	通达	无阻	交通	通	通行无阻	四通八达	直通	畅通无阻	风雨无阻	畅行	通行	风里来雨里去	畅行无阻
通风	透风	通气	透气
阻塞	闭塞	蔽塞	堵塞	梗塞	拥塞	淤塞	不通	梗阻	阻隔	隔阂	淤滞	梗	淤	死	过不去	堵截	卡脖子	绿灯	打断	短路	阂	死死的	围堵	封堵	查堵	卡住
卡	鲠	叉	咬	卡壳	轧	噎	障
漏	透	渗透	渗漏
漏水	渗水	渗出
漏风	透风
漏光	透光
漏气	透气
交界	分界	接壤	邻接	毗邻	毗连
靠近	邻近	接近	临近	挨近	贴近	将近	近乎	靠拢	凑拢	拢	凑	守	近	傍	滨	即	濒	濒临	濒于	临	临到	挨着	凑近	身临其境	驶近	走近
紧靠	紧贴	相依	偎依	偎	比	附	挨	把	倚	就	促	靠
逼近	迫近	逼	薄	压	临界	压境	侵	旦夕存亡
相距	距离	离开	离	去	距	偏离	相差
连绵	绵亘	曼延	绵延	连连	逶迤	迤逦	此起彼伏	连绵不断	连续不断	绵延不断	持续性	绵绵不绝
相隔	分隔	隔	相间
围绕	环绕	缠绕	盘绕	环抱	回环	拱抱	拱卫	围	圈	环	拱	绕	萦	缠
包围	包	重围
簇拥	拥	前呼后拥
扭结	纠结	纠	交融
交叉	交	叉	交加	立交
交错	纵横	阑干	犬牙交错
混杂	搀杂	夹杂	糅杂	糅合	错落	混合	交织	搅混	搅和	交集	插花	杂	混	夹	糅	泥沙俱下	龙蛇混杂	鱼龙混杂	良莠不齐	掺	混同	错综	勾兑	掺杂
超重	过重	超载
传导	传	导	输导	传输
传播	传布	散播	流传	传扬	扩散	传	不胫而走	不翼而飞	传出	传唱	传到	传来	传颂	传诵	传入	传回	传遍	传感	广为流传	盛传	长传	传开	广为传颂
流传	传	垂	沿	沿袭	一脉相传	衣钵相传
世传	传世	世袭	家传	祖传	世代相传	薪尽火传	传代	传种	宗祧	代代相传
传说	相传	风传	哄传
谣传	以讹传讹	谬种流传
流行	风行	盛行	风靡	时兴	兴	盛	大行其道
成风	蔚然成风	蔚成风气
相沿成习	约定俗成
连接	连	通	接	搭	属	交接	接合	衔接	连通	通连	连贯	连缀	接通	对接	过渡	紧接	连结	连着	联接	联网	接入	相联	连片	连成一片	成群连片	中继
承	承接	承上启下	承先启后	承载	承前启后
联系	关联	牵连	关系	维系	挂钩	沟通	搭头	联络	具结
组网	连网
纠缠	缠	绕	绞	萦	缠绕	绕组
积压	积	郁	郁结	郁积
结合	组合	结成	构成	组成	做	成	结	结节	结缘	烧结	粘结	血肉相联	粘连	咬合	整合	重组	三结合
割裂	隔断	隔绝	隔离	断	切断	凝集	与世隔膜
相持	对峙	对垒	对抗	对立	胶着	分庭抗礼	对阵	僵持	势不两立	胶着状态	对攻
鼎立	三足鼎立
生效	见效	奏效	收效	立竿见影
失效	失灵
陪衬	烘衬	映衬	衬映	衬托	烘托	掩映	相映	铺垫	烘云托月	搭配	反衬	配搭	选配	银箔衬
点缀	装点
定局	决定	定	已然	成议	稳操胜券	木已成舟	覆水难收	生米煮成熟饭	操胜券	一锤定音	注定	尘埃落定
未定	未决	存亡未卜	没准儿
已婚	成家
团结	合力	通力	协力	并肩	团结一致	精诚团结	群策群力	打成一片	抱成一团	大团结	合璧	融汇	互联	同苦共乐	大一统	团结一心	圆融	同甘	同苦	忧患与共	甘苦与共	并肩作战	一损俱损	扎堆儿	强强联合	同甘苦
同心	齐心	一条心	齐心合力	同心同德	同心协力	戮力同心	众志成城	同仇敌忾	敌忾同仇	并力	上下一心	上下齐心
和衷共济	同舟共济	同甘共苦	呼吸与共	休戚与共	患难与共	风雨同舟	各司其职	人和	荣辱与共	融合	融为一体	生死与共	万众一心	携手并肩	齐心协力	一心一德	众人拾柴火焰高
求同克异	求同存异
合并	归并	归拢	归总	统一	集合	汇合	联合	联结	联	合	合而为一
一统天下	世界一统
三位一体	统一体
分裂	瓦解	支解	解体	崩溃	土崩瓦解	分崩离析	四分五裂
分道扬镳	各行其是	各自为政	各谋其政	各持己见	各奔东西	各奔前程
离心离德	同床异梦	貌合神离	各执一词
团聚	聚会	聚首	团圆	大团圆	鹊桥相会	欢聚一堂	团圆饭	阖家团圆	围聚	相聚	共聚	欢聚	欢聚一堂	会聚	分久必合
离别	分别	作别	别离	分离	分开	分手	解手	诀别	分袂	暌违	仳离	别离	合久必分
背井离乡	离乡背井	离京	不辞而别
阔别	久别	久违
永别	永诀
集合	聚合	凑合	会合	会师	集聚	汇聚	聚集	丛集	齐集	集结	结集	聚拢	围拢	凑拢	聚	集	凑	汇	凑集	怀集	联谊	聚众	攒动	成团	萃	会集	聚拢	集纳
聚齐	取齐	集中	汇集	汇流	汇总
密集	麇集	成群结队	三五成群	攒三聚五	凑数	凑足	凝	凝聚
纠集	纠合	啸聚	结社	总汇
云集	荟萃	集大成	鸾翔凤集	济济一堂	群蚁附膻
分散	疏散	散开	散落	散	分流	散架	粗放	发散	散放
星散	风流云散	飘散	四散
离散	天各一方
妻离子散	鸾飘凤泊	劳燕分飞
如鸟兽散	树倒猢狲散
占先	领先	打头	打先锋	一马当先	遥遥领先	打前站	打头阵	最前沿
为首	带头	领头	领衔	捷足先登	牵头	敢为人先	领袖群伦	为先
争先	抢先	抢	争先恐后	先发制人	先声夺人	奋勇争先	竞相	争相	先下手为强
殿后	排尾
落	掉
命中	打中	击中	中	猜中	击中要害	枪响靶落	切中	歪打正着
进步	上进	向上	提高	发展	前进	长进	百尺竿头，更进一步	更上一层楼	竿头日进	进化	腾飞	升华	迈入	前行	上扬	上移	开拓进取
奋进	跃进	迈进	猛进	高歌猛进	突飞猛进	一往无前	勇往直前	阔步前进	昂首阔步	乘风破浪	长风破浪	破浪前进	拚搏	义无反顾	奋发上进	势在必进	前进不懈	求进	锐意进取
渐进	循序渐进	稳步前进	由浅入深	稳中求进	稳中有进
并进	齐头并进
退步	落后	落伍	掉队	退化	后退	倒退	开倒车	走下坡路	滑坡	江河日下	滞后	向下
堕落	腐化	蜕化	失足	落水	败坏	窳败	腐败	蜕化变质	掉入泥坑	误入歧途	一误再误	不能自拔	玩物丧志	贪污腐化	不思进取	吃喝玩乐
实行	推行	履行	执行	施行	实施	实践	践	履	执	尽	行
遵行	奉行	普及	施训	推广
举行	召开	开	做
完成	完竣	完结	完了	完事	落成	交卷	成功	成就	就	好	完	竣	得	蒇	大功告成	瓜熟蒂落	水到渠成	一气呵成	大功告成	功德圆满	一挥而就	毕其功于一役	到位	形成	做到	不辱使命	姣好	不负众望
脱稿	定稿	杀青	汗青
脱手	出手	得了
实现	兑现	贯彻	落实	促成	心想事成	奋斗以成
耽误	延误	耽搁	愆期	违误	迟误	误	误工
拖延	延宕	耽搁	因循	迁延	捱	拖	宕	蘑菇	拖锚
期满	满	满期	任满
到期	到时	届时	届期	届	到	临	到点	截稿
过期	逾期	脱班	晚点	误点	过	超时
来得及	赶得及	亡羊补牢	赶趟	犹为未晚
来不及	赶不及	不及	不迭	措手不及	为时已晚
禁得起	经得起	禁得住	吃得住	吃得消	受得了
禁不起	禁不住	经不起	不堪	吃不消	吃不住	架不住	受不了
享福	纳福	享乐	享清福
吃苦	受苦	受罪	遭罪	吃苦头	风吹日晒
沾光	讨巧	受益	得益
占便宜	讨便宜	捡便宜	贪便宜
不劳而获	吃现成饭	无功受禄	坐享其成	坐收渔利	渔人得利	吃现成
受益匪浅	获益匪浅
互惠	互利
上当	受骗	上钩	冤	蒙在鼓里	吃一堑
吃亏	吃哑巴亏
走运	幸运	万幸	天幸	有幸	侥幸	碰巧	托福	走红运	洪福齐天	三生有幸	好运	鸿运	大吉	大幸
发财	发家	发迹	发家致富
暴富	暴发	发横财	发大财
吉利	吉庆	吉祥	吉	瑞	祥	祺	红	万事大吉	吉星高照	吉人天相	大吉大利	吉祥如意	开门红
倒霉	倒运	背运	背时	背	不幸	不祥	薄命	晦气	丧气	触霉头	命途多舛	命乖运蹇	生不逢时	恶运	困窘	窘困	噩运
多灾多难	祸不单行	雪上加霜	避坑落井
走投无路	走头无路
糟糕	坏	不得了	不好
顺利	顺手	凑手	顺遂	顺畅	顺当	顺	胜利	平顺	如愿	遂愿	得手	平平当当	顺顺当当	风调雨顺	一帆风顺	一帆顺风	乘风扬帆	无往不利	地利人和	万事亨通	左右逢源	得心应手	如臂使指	如愿以偿	尽如人意	天从人愿	称心如意	万事大吉	必胜	称心如愿	顺风	万事如意	一路顺风	苦尽甜来	瑞气盈门	畅顺
顺势	趁势	顺水推舟	借风使船	借水行舟	因势利导
不利	周折	不遂	坎坷	好事多磨	事与愿违	横生枝节	节外生枝	疙疙瘩瘩	逆水行舟	艰难曲折
尴尬	狼狈	窘迫	受窘	坐困	为难	两难	窘	僵	骑虎难下	势成骑虎	左支右绌	左右为难	不上不下	进退两难	进退维谷	哭笑不得	啼笑皆非
一筹莫展	束手无策	毫无办法	焦头烂额	内外交困	山穷水尽
折磨	折腾	揉搓	煎熬	磨难	磨
成名	扬名	驰名	出名	蜚声	驰誉	著称	一举成名	功成名遂	身价百倍	名扬四海	名满天下	一鸣惊人	一飞冲天	扬威	一炮打响	名声大振	名声鹊起	走红	成名成家	名扬	驰名中外	露脸
声名鹊起	万世流芳	万古留芳
名誉扫地	扫地	身败名裂	遗臭万年	臭名远扬	臭名昭彰
出丑	丢丑	丢脸	丢人	坍台	现世	见笑	现眼	出洋相	闹笑话	丢面子	丢人现眼	当场出彩	出乖露丑	方家见笑	狼狈不堪	落汤鸡	下不来	下不了台	辱没门庭	掉价
得志	得意	称意	腾达	飞黄腾达	春风得意	蛟龙得水	破壁飞去	洋洋得意	少怀壮志
失意	落拓	潦倒	蹭蹬	怀才不遇	穷途潦倒	潦倒终身	丧志	报国无门
失业	赋闲	砸饭碗	丢饭碗	待业	下岗	无业	待岗
丢官	免职	罢官
晋升	提升	升级	晋级	升格	升迁	升官	升任	荣升	递升	调升	飞升	调干	升级换代
扶摇直上	步步高升	官运亨通	一步登天	平步青云	直上云霄	鸡犬升天	夫贵妻荣	平步登天	青云直上	提级	升官进爵
降级	降职	贬职	左迁	降	贬	谪	降格	贬低
升贬	升降	浮沉	沉浮	与世沉浮	升升降降
入选	中选	当选	膺选	选中	相中	选为
考中	考取	中式	及第	折桂	取	蟾宫折桂	金榜题名	榜上有名
落第	名落孙山	落榜	落聘	落选
受累	黑锅
受冤	蒙冤	冤枉	冤屈	衔冤	含冤	饮恨	莫须有	含冤	冤沉海底	抱恨终天	奇冤
背黑锅	李代桃僵
平反	昭雪	雪冤	洗冤	申冤	洗雪	洗刷
受奖	获奖	得奖
受罚	抵罪	受过
被捕	落网	束手就擒
入狱	下狱	坐牢	在押	服刑	吃官司	陷身囹圄	身陷囹圄	锒铛入狱
得宠	受宠	得势
失宠	打入冷宫	坐冷板凳
扑空	吃闭门羹
碰壁	碰钉子	打回票	一鼻子灰
自作自受	自食其果	自掘坟墓	自投罗网	自取灭亡	飞蛾投火	咎由自取	玩火自焚	惹火烧身	作茧自缚	作法自毙	揠	自找
自讨苦吃	自找麻烦	自讨没趣	自寻烦恼
适得其反	事与愿违	帮倒忙	抱薪救火	揠苗助长	以火救火	弄巧成拙	画蛇添足	南辕北辙	过犹不及	弄假成真
断子绝孙	断后	无后	绝后
守寡	寡居	孀居
受灾	遭灾
闹灾荒	闹饥荒
旱	大旱	久旱	亢旱	旱魃为虐	赤地千里	水旱	崩岸	旱极	受旱
涝	洪涝
发水	山洪暴发	泛滥成灾	水漫金山	一片汪洋	雨涝
开口子	决口
受害	被害	遇害	遭难	蒙难	死难	遇难	罹难	落难	遇险
遭殃	祸从天降	深受其害
中弹	饮弹
遇刺	遇害
失火	起火	发火	失慎	走火
走电	跑电	漏电	电击
触电	电
失窃	失盗
迷路	迷途	迷航	迷失
失踪	走失	下落不明	不知去向	渺无声息
不见踪影	无影无踪	音信全无	杳无音信	杳如黄鹤	销声匿迹	杳无音讯
遗失	丢失	丢掉	不见	散失	丢	少	掉	不翼而飞	遗落	有失
闯祸	肇祸	惹祸	出事	出乱子	出岔子	惹是生非	酿祸
召祸	招灾惹祸	捅娄子
遇救	获救	得救
脱险	出险	死里逃生	虎口余生	劫后余生	九死一生	两世为人	避险	幸免于难
胜利	取胜	战胜	获胜	得胜	制胜	告捷	大捷	奏捷	奏凯	凯旋	胜	赢	捷	凯	出奇制胜	克敌制胜	旗开得胜	屡战屡胜	哀兵必胜	百战百胜	百战不殆	力克	常胜	大胜	力挫	节节胜利	大获全胜	前车之覆
战败	失败	打败	败阵	败北	败绩	失利	溃败	溃退	败	负	输	北	不战自败	负于	必败	败退	输给	落败	吃败仗	满盘皆输	国破家亡	败走麦城
惨败	大败	一败如水	一败涂地	损兵折将	弃甲曳兵	丢盔弃甲	人仰马翻	头破血流	溃不成军	辙乱旗靡	望风披靡	落花流水	溃	马仰人翻	全军覆没
覆没	覆灭	片甲不存
被围	腹背受敌	插翅难飞	四面楚歌
沦陷	陷落	失陷	失守
亡国	灭亡	沦亡	亡	灭
胜败	高下	胜负	输赢	成败
成功	成事	有成	打响	成	遂	得逞	得计	马到成功	水到渠成	功成名就	因人成事	中标	卓有成就	不负众望	事业有成	学有所成	一人得道
失败	挫败	破产	砸锅	受挫	挫折	跌交	败	黄	垮	踬	砸	栽跟头	功亏一篑	功败垂成	败诉	寡不敌众	栽斤头	夭	成不了	败退	惜败	难倒	告负	未果	没戏	吃败仗
垮台	坍台	塌台	倒台	完蛋	塌架	崩溃	溃灭	夭折	倒	玩儿完	呜呼哀哉	倾家荡产	旁落
倒闭	关闭	停闭	停歇	关门	关张	关	关门大吉	闭馆
停业	歇业	毁于一旦
打垮	搞垮
落空	泡汤	流产	吹	漂	一场空	一场春梦	南柯一梦	付之东流	鸡飞蛋打	前功尽弃	未遂
败露	东窗事发	图穷匕见
暴露	露	表露	露馅儿	露马脚	暴露无遗	不打自招	纸包不住火	此地无银三百两	直露	展露	爆出
显形	现形	原形毕露
大白	真相大白	水落石出
泄漏	透漏	走漏	泄露	走风	漏风	走漏风声	外泄
泄底	露底	兜底
失密	泄密	失机
赚	得利	盈利	盈余	获利	创汇	创利	够本	扭亏为盈	挣	挣钱	致富	赚钱	赚取	净赚	扭亏
亏	蚀	赔	折	赔本	蚀本	折本	亏本	亏蚀	赔帐	吃老本	赔钱	赔账	哑巴亏
损失	破财	海损	折价
亏空	亏欠	亏累	空	拖欠	缺损
合算	上算	划算	经济	划得来	占便宜	事半功倍	一石多鸟
一举两得	一箭双雕	多快好省
失算	划不来	得不偿失	事倍功半	小题大做	劳民伤财	因小失大	贪小失大	因噎废食	进寸退尺	舍近求远	偷鸡不着蚀把米	举轻若重
涸泽而渔	竭泽而渔	杀鸡取卵
失策	失计
失机	失时	坐失良机	失之交臂
丰收	丰产	丰登	大有	五谷丰登	多产	保收	硕果累累	购销两旺	仓满库盈
歉收	欠产	歉
开始	肇始	开端	肇端	造端	发端	开头	起头	起来	起	始	开	启	下车伊始	初步	上马	始于	从头	方始	始起	启幕	初始	初露	开班	始发	千帆竞发
入手	着手	动手	下手
开工	兴工	动工	上工
破土	破土动工
开学	始业
开市	开拔	开饭	开篇	开赛	开业
开动	开行	起步	起动	起先	启动	启航
启程	起程	登程	上路	动身	起身	起行	出发	首途
开车	发车
开航	起航	出航	启碇	起碇	起锚	拔锚	扬帆
起飞	起航
起运	启运	起
开幕	揭幕
开演	开场	开台
萌发	萌芽	萌动	萌生	萌
起跑	开战	开讲	开课	开犁	开锄	开镰	开张	开盘	开拍
入春	入夏	入秋	入冬
结束	收束	终止	收场	完结	收摊儿	了结	了却	终了	告终	了局	了事	完毕	完竣	告竣	竣工	停当	煞尾	收尾	扫尾	利落	终结	为止	截止	毕	罢	讫	完	结	收	煞	了	央	阕	一了百了	寿终正寝	查讫	得了	善终	了断	说尽	草草收场	殆尽
罢休	罢手	住手	歇手	甘休	善罢甘休	用尽
作罢	罢了
散会	闭会	休会	闭幕
散场	散	终场	剧终	落幕
毕业	卒业	结业
下班	下工	放工	收工
收操	下操
下学	放学
售完	售罄	脱销	销售一空
停止	终止	休止	止息	停息	停歇	打住	止住	煞住	下马	平息	停	止	艾	寝	息	住	辍	歇	休	已	罢	适可而止	偃旗息鼓	鸣金收兵	停下	悬停	人亡政	停停	告一段落
停滞	僵化	停滞不前	撂挑子	驻足
打烊	关门
熄灭	熄	煞车
停战	停火	化干戈为玉帛
住口	绝口	住嘴
中断	中止	中辍	停顿	顿	间断	抛锚	刹车	搁浅	半途而废	戛然而止	间歇	暂停
望而止步	驻足不前
进行	进展	开展	展开	拓展	拓
双管齐下	齐头并进	并举
继续	连续	延续	接续	蝉联	继承	累	承	继往开来	前赴后继	前仆后继	此起彼伏	踵事增华	持续	后续	接轨	维继	存续	余波未停	此起彼落
流逝	蹉跎	荏苒	光阴荏苒	无以为继
寒来暑往	年复一年	春去秋来	物换星移
重复	反复	重	复	再	一再	再三	故伎重演	故态复萌	老生常谈	老调重弹	三翻四复	翻来覆去	颠来倒去	叠床架屋	重申	反反复复	故技重演	重蹈覆辙	重蹈	陈年老辞	重温	再行
循环	轮回	循环往复	周而复始	大循环	巡回
微循环	小循环
变化	变	转变	变动	更动	浮动	变通	变更	变卦	变迁	扭转	转移	转	弯	别	生成	变化无常	变型	思新求变	应时而变	走形	成形
变幻	无常	变幻莫测	变幻无常	变化不定	千变万化	瞬息万变	夜长梦多	云谲波诡	波谲云诡	白云苍狗	风云变幻
多变	反复无常	朝三暮四	朝秦暮楚	朝令夕改	变化多端	摇身一变	变异	形成	演进	善变
演变	演化	衍变	嬗变
情随事迁	事过境迁	沧海桑田	移花接木
剧变	突变	急变	骤变	急转直下	面目全非	愈演愈烈
渐变	潜移默化	默化潜移
质变	变质	蜕变
变脸	变色	翻脸	一反常态
变味	霉变
变样	走样
成为	变成	成	变为	化为	化	改成	改为	化作
欧化	西化
改变	变更	更动	变动	改动	转移	改	移	转	反	改成	改观	更改	切变
改换	更换	变换	转换	换	易	变	撤换	代换	移	转移	演替	易位
轮换	替换	掉换	倒换	交替	更迭	调换
交换	鸟枪换炮	置换	包换	包退	换换	换成
改天换地	移风易俗	旋转乾坤	更新换代	星移斗换
改弦更张	改弦易辙
改元	改朝换代
改行	跳行
改名	化名	改名换姓	更名	改性	易名
改口	改嘴
转调	变调	移调
转车	换车	倒车	中转	转发	转化	转会	转接	转速	转向	转用	转账	转折	转正
扩大	壮大	扩充	扩展	扩张	恢弘	恢宏	推而广之
放大	放	放开	加大	扩	推广	拓宽	日见其大
膨胀	膨大	胀	涨	体膨胀	线膨胀	猛涨	暴涨	暴胀	微涨
蔓延	滋蔓	迷漫
伸长	伸
延长	延伸	延	拉开	延绵
延年益寿	益寿
收缩	抽缩	抽	缩	缩合
缩小	压缩	紧缩	简缩
缩水	抽水	冷缩	浓缩	缩编	缩短
浸湿	湿	沾	濡染	渍	浸润	浸透	湿邪	濡
增多	增加	加码	充实	增	长	多	加	添	益	搭	追加	平添	净增	加进	由小到大	日增	大增	有增无减
增长	丰富	助长	长	加上	累加	日益增长	抬高	添加
外加	附加	叠加	增大
递增	递加	与日俱增
激增	猛增	剧增	新增	有增无已	与年俱增	增产	骤增	陡增	增创	疯长
倍增	加倍	倍	倍加	成倍	乘以	双增长
增值	升值
添油加醋	添枝加叶
添补	增补	找补	抵补	补	填补	补充	补给	补缺	补偿	填空	找齐	上	续	添	加	互补	弥
补遗	拾遗	拾遗补阙	填平补齐
弥补	弥缝
减少	减去	缩减	减缩	压缩	削减	裁减	节减	核减	减	刨	抽	裒	消损	打折扣	滑坡	回落	减掉	减下	减小	释减	轻装简从	精减	调减
裁	淘汰
减半	折半	扣除
减员	裁员
裁军	精兵简政
骤减	剧减
优胜劣汰	选优淘劣
上升	升高	升	升起	升腾	蒸腾	腾达	腾	起	狂升	稳中有升
腾空	凌空	爬升	攀升	抬高	腾飞	飙升
提高	增高	拔高	升华
涨	上涨	高涨	水涨船高	飞涨	高升
涨潮	来潮	涨风	涨价	提速
跃升	跃居
下降	降落	下落	跌落	落	降	退	跌	降低	减低	减退	减色	低落	暴跌	回落	下跌	下滑	骤降	下挫	狂跌	滑降	销价	大跌	稳中有降
落潮	退潮	猛跌
降价	减价	跌价	削价	掉价儿	落价	廉价
贬值	毛	通货膨胀
升降	起落	起伏	沉降	大起大落	起降	涨落	潮涨潮落	涨跌
提前	提早	超前
推迟	延迟	推延	推	延	缓	延期	缓期	延缓	展缓	顺延	推移	滞缓
加快	加速	加紧	开快车	兼程	快马加鞭	增速
放慢	减速	减慢	缓一缓	缓手	缓减
巩固	固	加固
安定	安	压	定
增强	加强	提高	增高	增进	增长	滋长	如虎添翼	三改一加强
加剧	加深	加重	激化	强化	变本加厉	火上加油	火上浇油	加油添醋	深化
强国	兴国
削弱	减弱	衰弱	弱化	减杀	减	铄
冲淡	和缓	缓和	软化	降温
抓紧	赶紧
放松	松劲	松	放宽	松扣
好转	改善	改进	有起色	上轨道	渐入佳境	日臻完善
出头	转运	时来运转	转祸为福	因祸得福	否极泰来	苦尽甘来	重见天日	开云见日	起色
转危为安	化险为夷	逢凶化吉	绝处逢生	死里逃生	九死一生	文艺复兴	有色
再生	更生	复苏	复兴	枯木逢春	复业	复馆	勃发生机
改进	改善	改良	精益求精	刮垢磨光	更上一层楼
恶化	逆转	毒化	恶变
倾覆	大厦将倾	乐极生悲
更新	翻新	创新	换代	履新
面目一新	焕然一新	万象更新
破旧立新	除旧布新	推陈出新	革故鼎新	吐故纳新	花样翻新	除旧迎新	旧貌换新颜
整旧如新	更型换代	基础代谢	刷新	以旧翻新
复旧	复古
故态复萌	旧病复发	故伎重演	老调重弹
新生	新兴	初生	后起	后来	旭日东升	喷薄欲出
兴起	起来	突起	奋起	勃兴	群起	蜂起	起	风起云涌	四起	应运而起
衰落	没落	败落	破落	中落	凋敝	凋零	陵替	衰退	衰老	衰朽	退坡	萎缩	阑珊	衰	萎	强弩之末	日薄西山	大势已去	一落千丈	落花流水	再衰三竭	萎靡
衰败	颓败	破败	衰微	式微	衰颓
世风日下	人心不古
是	为	乃	系	则	属
就是	即	便是	就是说	乃是	身为	视为	说是	算得	特别是	实属
当做	当作	作为	看成	看作	看做	当	作	用作	视作	同日而语
算	算作	不失为	当成	奉为	真是	正是
比作	比方	好比	比喻	譬喻	打比方	况	拟人
叫做	叫作	叫	名	谓	称	曰	称为	称作	号称	称呼	称之为	誉为	谥	斥之为	喻为	名叫	名为	称做	何谓
自称	自封	自命
意味	表示	象征	代表	意味着
影射	隐射	含沙射影	指东说西	借古讽今	指桑骂槐	指鸡骂狗
体现	反映	映现
标志	标明	表明
显示	显得	来得	展示	示	显	著	亮	形	出示	呈示	剖示	兆示
显见	足见	可见	凸现	看得出
预示	预兆	预告	主	兆
证明	证实	证验	验证	印证	说明	应验	证	征	辨证	求证	认证	作证	验明正身
起源	来源	发源	导源	根源	来	自	源	来源于	来自	门源	缘于	源于	出自
取决	在于	在乎	有赖于	在	取决于	有赖
归于	归属	着落	属	落	归	责有攸归	直辖	百川归海	归入	名下
属于	属
隶属	直属	附属	附设	从属	依附	配属	专属
所属	分属
相同	同	雷同	同样	同一	一样	一律	一色	一致	划一	等同	同等	平等	翕然	一	平	一模一样	一如既往	千篇一律	天下乌鸦一般黑	毫无二致	如出一辙	无异	无异于	均等	等同于	一码事	等效	亦然	扯平	同义	扳平	等位
不约而同	殊途同归	异曲同工	同工异曲	不谋而合	如出一辙
众口一词	异口同声	众口一声
同年	同岁	同庚	同龄
同班	同窗
相等	相当	对等	等于	顶	当	抵	等	齐	侔	埒	半斤八两	等价	齐名	相当于
匹敌	敌	颉颃	抗衡	媲美	比美	伯仲之间	旗鼓相当	势均力敌	工力悉敌	不相上下	并驾齐驱	棋逢对手	分庭抗礼	相持不下	铢两悉称	平起平坐	平分秋色	拉平	平产	打平
等距离	等距
差不多	差不离	大同小异	五十步笑百步	各有千秋	战平	几近	差之毫厘	相差无几
不同	各别	两样	不一	不比	不等	殊	异	差	二	歧	人心如面	莫衷一是	言人人殊	见仁见智	龙生九子	今非昔比	不可同日而语	敌众我寡	各异	例外
迥	悬殊	上下床	截然不同	迥然不同	判若云泥	众寡悬殊	天差地远	寸木岑楼	大相径庭	面目皆非	物是人非	有所不同	迥然	迥异	迥然相异	殊异于世
相反	相左	悖	南辕北辙	戴盆望天	反之	恰恰相反	有悖于	反过来说	相悖	有悖
相似	相像	形似	貌似	似的	一般	般	诚如	维妙维肖	类同
近似	相近	切近	近乎	接近	仿佛	相仿	类似	类乎	类	八九不离十	好像	恍如	恍若	看似	像样	象是
好似	似乎	如同	有如	不啻	宛然	宛如	犹如	像	宛	似	若	如	犹	宛若
活像	酷似	神似	恰似	恰如	俨然	俨如	肖
例如	比如	譬如	诸如	如	像	比如说	譬如说
如下	如次	一般来说	正如	正象	之类
超过	超出	超越	压倒	不止	凌驾	盖	浮	超	过	逾	有过之无不及	大于	高于	过量	超乎	出乎	胜出
胜于	胜似	强似	胜	赛	强	愈	高	大	略胜一筹	后来居上	过人	青出于蓝	稍胜一筹	胜过
不及	不如	不比	没有	比不上	逊色	亚	低	小	低位	亚于	自愧弗如
相形见绌	相形失色	小巫见大巫	望尘比步	略逊一筹
不可企及	望尘莫及	低于	仅次于	小于	逊	自愧不如
适应	服	适于	恰切
相配	般配	匹配	配合	相称	相当	匹	门当户对	郎才女貌	兼容
相辅相成	相辅而行	相得益彰	对称	珠联璧合
符合	吻合	适合	切合	契合	合乎	相符	符	副	合	切	入	抱	可	称	严丝合缝	顺应	核符
相投	对	对头	对劲	合得来	说得来	投契	投机	投缘	合辙	合拍	入港	莫逆	一见如故	情投意合	心心相印	志同道合	意气相投	气味相投	对劲儿	投合
臭味相投	沆瀣一气	一鼻孔出气	对味	合群	酒逢知己
巧合	偶合	戏剧性
不合	不符	方枘圆凿	圆凿方枘	文不对题	答非所问	前言不搭后语	牛头不对马嘴	驴唇不对马嘴	走调儿
名不副实	言过其实	名过其实
合不来	说不来	话不投机半句多	话不投机
相对	对立	针锋相对
矛盾	抵触	龃龉	拧	格格不入
自相矛盾	水火难容
需要	需	要	消	欲	用	得	待	索要	亟需	急需	亟待	内需	特需
提供	供	资
供给	供
供应	支应	供
满足	饱
供求	供需
连贯	贯通	贯注	贯穿	贯串	贯	纵贯	由上至下
呼应	相应	照应	应和	前呼后应	首尾相应	对应	附和	随声附和	遥相呼应	对号入座
易于	容易	易	善	好	爱	轻	便于
存在	在	有	是	存	留存	设有
硕果仅存	鲁殿灵光	社会存在
共存	共处	依存	并存	长存	存活	古已有之	水土保持	万古长存	现有	幸存	永世长存	存世
遗留	留	剩	遗	贻	留置	残留	残存	余蓄
留	蓄	养	留成	留给	留下	留住	雁过拔毛	预留
保持	维持	护持	维系	保全	保	葆	涵养	保障
撑持	支持	支撑	绷	永葆	引而不发
处于	居于	处	处在	地处	远在	介乎	高居	占居
位于	坐落	在	居	厕	厕身	置身	放在	位居	雄居	座落	处身	身处
沉浸	沐浴	正酣
在于	在乎	在	介于
陷于	陷入	陷落	沦	沦落	沉沦	困处	沦为	深陷
适逢	适值	遭逢	正逢	恰逢	正当	时值	正值
登载	刊载	刊登	见报	发表	上	刊	载	登	刊出	报载	披载	登出	摘登
有	拥有	保有	领有	所有	具有	赋有	享有	富有	负有	具备	享	具	备	兼而有之	持有	独具	怀有	兼备	有了	有所	有着	装有	秉赋	实有	颇具	赋有	存有	抱有	兼有	兼具	不无
集体所有	共有
还有	再有
占有	占据	占	霸占	挤占	占用	夺占	据为己有
容纳	包容	容	盛	兼容并包	兼收并蓄	无所不容
包括	囊括	包罗	牢笼	席卷	总括	概括	赅	包	连	不外乎	统揽	揽括
充满	充塞	充溢	填满	洋溢	飘溢	充斥	浸透	载	满	盈	满盈	括	满载
满怀	包藏	怀	蓄	存	衔	抱	怀着	满腔
包含	含	噙	包孕	带有	含有	含蓄	蕴涵	蕴蓄	韫	寓	蕴	蕴藏	蕴含	蕴藉	饱含	分包	隐含	富含	涵	盈盈	包蕴	暗含	深蕴	涵盖
显露	表露	流露	显	露	现	发	透	漾	泛	浮	浮泛	浮现	敞露	发泄	发自	露出	显出	外露	突显
呈现	显现	表现	展现	见	变现	纷呈
出现	现出	长出	冒出	涌出	起	辈出	并发	产出	迭出	面世	应运而生	油然而生	出新
闪现	昙花一现
再现	重现	复发	复出
层出不穷	层见叠出
冒尖儿	脱颖而出	兀现	喷薄而出	脱颖出
兀现	毕现
发生	产生	发出	生出	生	起	闹	有	来	出	发	时有发生
散发	发	散	泛
突发	爆发	横生	突如其来	从天而降	平地一声雷
萌生	萌芽	萌发	萌
发作	犯	作	发
消失	消散	消灭	消亡	消逝	消释	消解	消退	冰释	没有	熄灭	破灭	毁灭	陨灭	澌灭	泯灭	泯没	磨灭	泯	磨	消	逝	幻灭	收敛	烟消云散	云消雾散	涣然冰释	瓦解冰消	冰消瓦解	一去不复返	泥牛入海	无影无踪	荡然无存	石沉大海	化为乌有	风流云散	烟云过眼	过眼烟云	付之一炬	付之东流	灰飞烟灭	付诸东流	流失	一去不返	冲消	淡去	不复存在	远逝	烟退云敛
告罄	罄尽	绝迹	灭绝	销毁	绝灭
失去	失掉	失却	失	去	夺	错过	错开
丧失	丧	沦丧	错失	痛失
散失	逸	佚
灭种	绝种
失传	绝版
恢复	还原	复原	回复	平复	光复	复	回升	过来	死灰复燃	借尸还魂	东山再起	卷土重来	重起炉灶	重操旧业	回心转意	破镜重圆	和好如初	复壮
缓	缓气	复苏	苏	休养	休息	休养生息
摧毁	毁灭	损毁
解决	速决	迎刃而解	解铃系铃	釜底抽薪	化解	缓解	排忧解难	速战速决
克服	战胜	排除万难	摆平
消灭	扑灭	扫灭	灭	除	锄	锄强扶弱	除恶	摧
荡涤	涤荡	扫荡	横扫
灭绝	根绝	杜绝	除根	根除	肃清	廓清	连锅端	斩草除根	斩尽杀绝	一扫而空	除恶务尽	杀灭	一扫而光	剪草除根
灭鼠	灭菌
消除	打消	化除	破除	扫除	驱除	免除	铲除	剪除	清除	解除	防除	割除	革除	摒除	摈除	拔除	祛除	排除	屏除	攘除	消弭	去掉	免去	排遣	消	弭	免	破	祛	排	解	败	脱	纾	辟	散	摒	禳	除掉	勾除	洗消	免掉	拨冗
洗雪	昭雪	雪	洗	洗刷	归除	剿除
戒除	戒	断	改掉	力戒
抛弃	摈弃	捐弃	丢弃	废弃	撇弃	屏弃	毁弃	遗弃	废除	丢掉	撇开	扔	抛	撇	废	弃	委	丢	撇下	忍痛割爱	闲弃	摒弃	抛开	剥弃	摈	遏	挥之即去
舍弃	放弃	割舍	割爱	舍	扬弃	舍本求末	舍去
葬送	断送
埋没	湮没	湮灭
牵连	牵累	连累	拖累	带累	累及	牵涉	牵扯	攀扯	拉扯	拉	关	爱屋及乌	关连
株连	卷入	连锁反应
涉及	关涉	关联	关系	关乎	波及	旁及	涉	干	涉嫌	提到	事关	兼及	论及
相关	相干	有关	连带	连锁	系	休戚相关	息息相关	骨肉相连	呼吸相通	血脉相通	唇齿相依	辅车相依	痛痒相关	诖	不无关系
无关	无干	不相干	了不相涉	漠不相关	不关痛痒	井水不犯河水	风马牛不相及	毫不相干
影响	熏陶	潜移默化	默化潜移	震慑
触动	感动	打动	拨动	震动	激动	震撼	撼动	撼	动
动摇	摇撼	敲山震虎
动人心魄	荡人心魄	撼人心魄	荡魂摄魄
带动	牵动	带	带来	拉动
沾染	浸染	染	习染	濡染	感染	熏染	耳濡目染	染上
传染	传	招	染	污染
引起	唤起	挑起	引	逗	招	勾	惹	挑起	招惹	滋生
吸引	招引	抓住	诱惑	诱	掀起	引发	挑动
导致	招致	以致	引致	诱致	致使	招	致	促成	造成
使得	使	令	让	叫	教	俾	驱动
促使	驱使	敦促
催生	催产
给予	授予	赋予	付与	予以	给以	给	与	予	致	施	赋	加之	寓于	给与
寄予	寄托	寄	依托	委以
加以	加	给定
施加	强加	横加	栽	致以
冠以	冠
推动	推进	促进	助长	推	有助于	推波助澜	推涛作浪	后浪推前浪	递进	推向	力促
激发	激起	激励	激扬	刺激	振奋	鼓舞	激
提神	兴奋	拔苗助长	鼓劲	条件刺激
妨碍	碍	妨	伤	有碍于	有碍
杜绝	杜	堵塞
限制	限量	限定	范围	限	拘	克	画地为牢	界定
局限	囿	受制	囿于
约束	约	格	绳	束	敛	律	框	拘束	束缚	系缚	羁绊	牢笼	封锁	自律	羁
钳制	牵制	制约	牵掣	掣肘	钳	制	制裁
制止	抑止	抑制	压制	遏制	扼杀	压	挫	杀	平抑	限于
支配	决定	主宰	驾御	控制	宰制	操纵	操	说了算
超越	逾越	跨越	超过	越	跨	超	跳	躐	逾	过	超常
有利	利于	有益	惠及	造福	福利	便利	方便	便宜	利	好	便民	便于	开卷有益	一本万利	有利于	有益于
富民	利国利民	利民	利国
有害	损害	伤害	危害	祸害	妨害	残害	戕害	戕贼	贻误	损伤	挫伤	摧残	侵蚀	侵害	害	祸	误	危	损	伤	贬损	害人	加害	迫害	误伤	重伤
不利	不利于	有损	有损于
无损	无害
防止	防备	防范	防护	预防	提防	严防	警备	戒备	防	备	戒	防微杜渐	防患未然	谨防	曲突徙薪	以防	以防万一
避免	幸免	避	免
逃避	规避	躲避	回避	逃脱	躲开	逃	避开	躲过	避让	逭
避讳	忌讳	切忌	忌	讳	顾忌	忌口
免得	省得	以免	免于	免受
取得	得到	获得	博得	赢得	获取	博取	收获	到手	得	取	获	抱	博	落	沾	拿走
垂手而得	近水楼台先得月	查获	垂手可得	得出	汲取
失而复得	合浦还珠	得来	应得
荣获	荣膺	捧得	喜获	荣立
争取	争得	力争	分得
夺取	夺得	夺
牟取	谋取	牟	渔	拿到
达到	达成	达	臻	上	齐	及	落到	落得	达标	高达	直达
遂	称	如
挽回	扳回	扭转	力挽狂澜
遭受	蒙受	受到	遭遇	遭逢	受	遭	吃	被	罹	挨	负	中	着	蒙	遇	丁	饱尝	饱受	倍受	备受	惨遭	屡遭	面临	未遭	遭到	遭劫
享受	消受	享用	享	大饱眼福	大快朵颐	分享	身受	飨
接受	领受	收受	承受	经受	受	领	禀	奉	膺	纳
秉承	禀承	受命	采纳
忍受	禁受	经受	消受	受	禁	经	熬	熬煎	经得住
非常	异常	特别	格外	分外	十分	十二分	万分	不胜	百般	百倍	充分	老大	好生	好不	那个	要命	不行	可怜	了不得	不得了	够劲儿	够呛	很	甚	颇	挺	好	老	生	深	良	殊	煞	大	雅	綦	稀	绷	酷	怪	蛮	杀	死	慌	坏	不可开交	死去活来	甚为	煞是	深深的
远	多	大为	极为	颇为
多么	多	何等	何其	万般	多多
最	顶	极	尽	绝	太	透顶	绝顶	极其	极端	极度	卓绝	不过	无上	无比	无限	无以复加	无与伦比	莫此为甚	最好	最为	至极	最最	极致	亢
至多	最多	大不了	充其量	不外	顶多
至少	最少	起码	足足
过分	过度	过头	过火	过于	忒	超负荷	矫枉过正
尽量	放量	充分	尽管	尽
殚思竭虑	殚思极虑
更加	更其	越加	越发	一发	尤其	愈加	越来越	愈来愈	进一步	更	逾	愈	越	益	更进一步	更是	更为	益发	尤为	愈发	愈益	越是	进而
相当	一定	一对一
比较	较比	较为	较
稍微	稍为	稍许	稍稍	约略	略略	微微	略微	些微	些许	有点	有些	多少	稍	略	微	粗	小	聊	不怎么	略带	略为	稍事	稍加	多多少少
大多	多	大半	大都	大抵	基本上	差不多	几近
完全	全然	截然	全盘	通通	统统	精光	一齐	全	净	毕	了	悉	意	一古脑儿	浑然	一点一滴	一心
全数	如数	悉数
精光	净尽	光	净	绝	杀光
纯粹	纯	彻头彻尾	片甲不留	片瓦无存	淳	上无片瓦
彻底	到底	到头	翻然	干净	根本	压根儿	穷	根	清	彻	到顶	一干二净	完完全全	绝望
半半拉拉	一半	半	大体上
都	净	全	统	均	备	皆	俱	咸	胥	佥	全都	通通	通统	统统	一总	清一色
一概	一律	概	概莫能外	个个	毫无例外	无不
只	单	独	光	止	就	仅	但	才	徒	特	惟	单单	仅仅	不过	偏偏	惟独	单独	独自	唯有	只有	只是	无非	单纯	一味	惟有
只不过	左不过	光是	仅只
不止	不仅	不光	不只	不单	不啻	不仅仅
甚至	乃至	甚而	甚或
立刻	即刻	立时	即时	立地	马上	立即	随即	当即	迅即	当下	登时	顿时	顿然	及时	眼看	当时	应时	应声	旋踵	旋即	立	就	即	这	二话没说	立马
赶快	赶早	赶紧	赶忙	急忙	连忙	从速	尽早	及早	尽先	争先	尽快	快	抢	赶早不赶晚	不久	趁早	急匆匆	从快	迅雷不及掩耳之势	奋勇争先
逐渐	逐步	渐渐	慢慢	日渐	日趋	逐日	逐月	逐年	渐次	渐	浸	日益	逐级	缓缓地
姑且	暂且	权且	权时	聊	且	权	姑	待会儿	姑妄听之
临时	旋	现	即
预先	预	先	先期	先行	事先	优先
首先	率先	第一	先是
准时	正点	限期	如期	按期	按时
经常	时常	常常	素常	时时	每每	不时	时不时	时	常	常川	常事	隔三差五	频仍	三天两头
一再	再三	多次	屡次	累次	屡屡	累累	比比	频繁	反复	屡	累	迭	频	数	亟	勤	屡次三番	三番五次	翻来覆去	往往	再而三	高频	几度
向来	素来	历来	自来	从来	根本	一向	平素	平生	素	向	从	固	有史以来	从古至今	从古到今	历久	常有	素有
本来	原来	原本	原先	原	本	本原	元元本本
不断	不止	不停	不住	不休	不了	不迭	不已	不辍	无间	穿梭	源源	频频	连连	连	绵绵	缕缕	无休止	络绎不绝	没完没了	无尽无休	不绝于耳	不息	持续	日日	时时刻刻	随地	相接	相连	连发	循环不断	延绵不断	无穷的	迭起	高潮迭起	娓娓
一口气	一股劲儿	一鼓作气	一气	一举
一连	接连	连接	连连	连续	连	连天	连日	连年	累年	连珠	接二连三	接连不断	连续不断	一个劲	总是	连日来	老是
源源不断	源源不绝
一直	一味	直	老	总	尽	辄	迄	镇	始终
时刻	时时	随时	天天	无日	无时无刻	每时每刻	整日	时时处处	事事处处
每次	历次	次次	老是
动辄	动不动	动
已经	曾经	业经	业已	早已	早就	久已	已	曾	就	既	都	一度	现已
方才	刚才	适才	才	刚	刚刚	顷	方	甫
新	初	乍	将才
正在	正	在	方	着	正值
随即	随后	接着	跟着	跟脚	跟手	继而	继	就	继之	紧接着	进而	随着	随之
即将	行将	快要	就要	将	且	将要
终于	终究	终久	终归	到底	毕竟	总算	算是	算	终	卒	竟	好不容易	到头来	归根到底	好容易
再	又	重	更	还	复	再度	再次	重新	从新	重复	双重	再行	再也	另行
不再	不复
必然	决然	自然	势必	必将	必定	肯定	一定	准定	定	必	得	一准	定准	迟早	早晚	决计	毫无疑问	大势所趋	势将	终将
意料之中	不出所料	定然	决非偶然	自然而然
不可逆转	不可避免
十有八九	十之八九
管保	保管	管教	包管	保险	保证	准保	确保	担保	保	包	管	打包票	作保	保准	承保	力保
未必	不一定	未见得	不见得	不致于	不至于
难保	难说	保不定	没准
突然	忽然	突兀	猛然	骤然	蓦然	陡然	遽然	霍然	赫然	猝然	蓦地	霍地	忽地	猛地	忽	突	陡	骤	猝	冷不丁	抽冷子	冷不防	猛不防	突如其来	平地一声雷	出敌不意	出人意料	出人意外	黑马	幡然	倏然	猛然间	豁然	恍然	爆冷	闪电式
偶然	偶尔	偶发	偶	间或	有时	奇迹	有时候	偶发性	突发性
不料	不图	不虞	不意	意外	不测	竟然	奇怪	飞	竟	想不到	殊不知	出冷门	出乎意料	出乎意外	意料之外	出其不意	谁知	想得到	意想不到	骤起	始料不及	始料未及	不可捉摸
也许	或许	容许	或者	或	可能	恐怕	恐	想必	兴许	说不定	或是	谅必	莫不	指不定	唯恐
大概	大略	大约	约莫	大致	大体	八成	光景	敢情	约	横	盖	备不住	粗粗	大体上	大致说来	大约摸	约摸
难道	莫非	莫不是	别是	岂	宁	难道说
不	非	匪	无	未	弗	勿	莫	休	毋	免	请勿	切莫
不用	甭	无须	并非	毫不	毫无	决不	绝不	休想	永不	不要
没	没有	未曾	未尝	无	毋	罔	靡	莫	不曾	从不	从未	从未有过	尚未	一无	并未	尚无	从来不	从没	绝非	远非
四顾无人	无人
竭力	极力	尽力	一力	悉力	努力	大力	鼎力	全力	奋力	拼命	使劲	用劲	全力以赴	竭尽全力	不遗余力	卖力	皓首穷经	用力	铆劲	力竭声嘶	努	着力	力图	鼓足干劲	开足马力	耗竭	不竭	恪尽	矢志不渝	忙乎
尽量	不择手段	狠命	竭尽	尽可能	尽力而为	尽其所有	倾心尽力	死命	玩命	拚命	尽心	尽心尽力	尽心尽意	拼命三郎	硬着头皮	苦斗
任意	肆意	随意	恣意	任性	无度	自由	随便	轻易	擅自	随心所欲	不管三七二十一	随随便便	无限制	即兴	人身自由	妄动	随机
尽情	任情	忘情	纵情	痛快	畅快	畅	好好儿	敞开儿	自做主张	流连忘返	留连
胡乱	胡	乱	滥	混	瞎	妄	乱七八糟
特意	特地	特为	特别	专门	专诚	专程
故意	故	有意	蓄意	假意	成心	存心	有心	有意识	明知故问	明知故犯	特此	特有
顺便	就便	趁便	乘便	顺手	顺带	附带	捎带	捎带脚儿	有意无意
随口	顺口	信口
随手	顺手	跟手	信手	就手
顺路	顺脚	顺道
随身	身上
无心	无意	误	无意识	下意识	不知不觉	平空	潜意识	无形中
借故	托故	假托	推托	借口	假说	托词	托辞
托病	称病
无故	无端	凭空	平白	平白无故	无缘无故
执意	硬是	就是
只得	只好	只能	不得不	唯其如此
共同	协同	一同	一道	一起	一齐	一块儿	一路	一头	一并	联合	合伙	伙同	伙	并	合	齐	共	同	旅	偕	合办	齐声	同步	同船	协	一块	联袂	联手	手拉手	联名	同台	联机	协办	同机
分头	分别	个别	各自	并立	独家	各行其事	分级
独自	单独	独立	独力	独	单身	单个儿	只身一人	独门
互相	相互	交互	相	互	彼此	互动	互为	竞相	相互之间	并行
从中	居中	居间
亲自	亲身	切身	亲	躬
亲手	手
挨次	顺次	依次	以次	次第	顺序	相继	逐一	一一	逐个	各个	挨个儿	历	逐	挨个	挨家挨户	挨门挨户	逐项	逐条	梯次
轮流	轮番	轮班	轮换	交替	更迭	更替	轮岗
交叉	穿插	接力	陆续
迎头	当头	劈头	一头	迎面	劈脸	扑鼻
迎风	逆风	顶风
径自	径直	径
直接	径直	一直	直	第一手	直白
就地	当庭
间接	转弯抹角	拐弯抹角
恰巧	刚巧	凑巧	可巧	碰巧	偏巧	赶巧	正巧	恰好	正好	刚好	可好	恰恰	刚刚	恰	刚	巧	正	适	适逢其会	无独有偶	正要
幸亏	多亏	亏得	幸而	幸好	幸喜	难为	亏	幸	好在	正是
偏偏	偏巧	不巧	偏	独独
竟然	居然	竟自	甚至	竟	还	还是	甚至于	竟是
几乎	差一点	差点儿	几	殆
险些	险乎	险	差点
仍然	依然	仍旧	依旧	兀自	仍	还	还是	照旧	照例	照样	援例	一仍旧贯	一如既往	依然如故	依然故我	如故	反之亦然
尚且	还	都	犹	且
索性	爽性	干脆	简直	一不做
毕竟	究竟	终究	到底	终归	总归	总	归根结底	说到底	终竟
简直	直	直截
固然	固	虽	虽然	诚然
反正	横竖	横	左右	左不过
实在	委实	着实	确实	的确	确乎	真个	当真	真正	真	确	委	洵	审	诚	诚然	真的	确确实实
果然	果真	果	果不其然
其实	实则	实在	实际	实际上	实质上	骨子里	事实上	莫过于
不免	未免	难免	免不了	免不得	在所难免
莫如	莫若	不如
无怪	难怪	无怪乎	怪不得	怨不得
未尝	何尝	未始
毋宁	无宁	不如	与其	倒不如	与其说
宁可	宁肯	宁愿	宁	情愿
究竟	究	到底
不妨	无妨	何妨
千万	万万	切切	断断	断乎	断然	绝对	切	绝	决	断	纯属	绝对化
当然	自然	当	自	自是	本来	本	理所当然
却	可	倒	也	倒是
还	尚
也	亦
反而	相反	反是	反倒	倒转	反	倒
这样	这么	这么样	这么着	如此	如斯	然	如此这般	这一来	诸如此类	这般
那样	那么	那么着	恁	那么样	云云	那般
哪里	哪	岂	何	乌	何在
怎样	怎么	怎的	怎么样	怎么着	怎	哪样	何如	何等	何许	什么	如何	何以	哪	争	安	焉	哪边	哪些	什么样	咋样	该当何论
为什么	干什么	干吗	为何	为啥	何故	何以	怎么	怎	胡	缘何
何不	盍	曷
向	朝	望	往	奔	为	于	朝向	朝着	通往	通向	径向	向心	向阳
对	迎	当	冲	给	劈	照	面	面对	直面	相向
趋向	趋于	趋	锋芒所向
背	坐	背靠	背着
在	于	当	以	每当
从	自	由	打	起	于	自从	打从	自打	从今
到	至	及	暨	迄	顶	届	交
等到	待到	及至	赶	逮	迨
以至	直至	直到	截至	以至于
沿	缘	挨	顺	本着	顺着	沿着
跟	同	与	和
替	给	为	同
把	将	管	拿
比	比较	较	于	正如	可比
对于	对	于	对此
关于	有关	至于
为	以	为	为着	为了	以便
被	叫	让	为	吃	于	给	受	深受
以	用	拿	将
由	归
依靠	倚靠	指靠	依傍	靠	依	倚	因	乘	仗	仰	怙	恃	指	负	据	凭	赖	仰赖	依赖	倚赖	借重	倚重	借助	依仗	倚仗	凭仗	仰仗	仰承	依凭	凭依	凭借	拄	依赖性	赖以生存	借助于	赖以
取给	吃	藉	凭坚	凭着	死仗	自恃
靠水吃水	靠海吃海
通过	经过	经	透过	由此
依照	按照	比照	遵照	遵循	照	仍	本	依	以	按	论	准	据	比如	循	遵	随	按部就班	照说	以资	如约
按理	按说	按理说
依法	有法可依	有章可循
根据	依据	基于	因	冲	据悉
针对	对准	对	本着	照章	针对性	指向
趁	乘	迨	就	趁机	趁热打铁	趁早	趁着	乘机	乘胜	乘势	乘隙	乘兴	冲着	打铁趁热	就势	随着
有机可乘	有隙可乘
和	同	与	跟	暨	及	以及
连同	偕同	随同	会同	伙同	及其
或者	或	抑或	还是	要么	要	抑
并且	而且	同时	并且	而	又	以	与此同时	再就是	再者	还要
况且	而况	何况	况	加以	再说	再则	更何况	再者说
但是	只是	可是	不过	然而	可	然	而	但	然则	唯独	而是
虽然	虽说	虽则	虽	则	尽管	尽管如此
即使	即若	即令	即或	即便	就算	就是	尽管	哪怕	不怕	纵使	纵令	纵然	纵	饶	即	就	便	虽	即使如此	不畏
既然	既是	既	既然如此
不但	非但	不单	不惟	不仅	不光	不只	不独	非独	非徒	岂但	不仅仅
何止	岂止
连	并
凡是	凡	是	大凡	举凡
除了	除去	除开	除	除外	不外乎	除此之外	而外	除却
除非	只有	惟有
若非	要不是
否则	要不	不然	要不然	不然	再不
庶几	庶	才
如果	如其	如若	假若	设若	设或	倘或	倘若	假如	假设	假定	倘使	假使	设使	要是	若是	倘	比方	万一	若	如	要	设	而	苟	倘	使	一旦	一经	倘然	若果	只要
那末	那么	那	这就是说
因为	因	为	缘	以	坐	盖	归因于
由于	鉴于	由	出于	是因为
由此可见	有鉴于此
所以	因而	因此	故此	故而	从而	故	用	据此	于是	之所以	为此	就此	因故
如上所述	总的来说	由此看来	总的看	看来
不论	无论	不拘	不管	任凭	随便	无	任	凭	管	任由	甭管	不论是	无论是	听由
好歹	无论如何	不管怎样	不顾	好赖
只管	尽管
于是	于是乎	遂	乃
此外	另外	除此以外	别有洞天	除此而外
哪堪	不堪
岂	怎	庸	怎么	怎生
是不是	是否
的	之	底
然	乎	之乎者也
等等	之类
来着	来
过	了	罢	喽
啊	啦	哪	哇	呀	呐
呢	者	吗	么	啊	也
喽	嘞	咯	罗	了
哩	呢	咧
呗	嘛
哟	吧	啊	者	嗬哟
吗	呢	吧	乎	啊	否	欤	耶	邪	为	哉	也	也罢	与否
的话	吧	来说	以来
罢了	而已	便了	耳	如此而已
了	矣
哉	矣	兮	乎	呜乎哀哉
喂	嘿	嗨
哎	喏	吠	唯
喳	啊	嗯
喔	噢	哦	啊
哼	吓	好	呔
嗳	嗯	唔
嘿	哈	哈哈
嗯	啊	哦	唔
嗨哟	哼唷
哎呀	哎哟	什么	好家伙	嘻	啊	嘿	嗬	哟	呀	哎	呦	嗬哟	咦
唉	嗳	咳
哈哈	嘿嘿	哄	哈哈哈
扑哧	哧
呜呜	哇哇	呱呱
哇啦	哇哇	叽里呱啦
叽叽嘎嘎	叽叽喳喳	唧唧喳喳	嘁嘁喳喳	叽里咕噜
喃喃	喁喁
咻咻	呼哧	吭哧
呼噜	咕嘟	咕噜	打鼾
噗	呼	哼哧
哇	哕	喀
啈啈	哼
咪咪	喵
啾啾	咬咬	呖呖	叽	喳喳	唧唧喳喳
喔喔	喔
咕咕	咯咯
嘎嘎	呱呱	咻咻	嘎	咻
呼呼	呜呜	飒飒	萧萧	簌簌	瑟瑟	修修	飕飕
淅沥	滴答	滴滴答答
刷刷	哗哗	哗啦	哗啦啦
隆隆	咕隆	隐隐	虺虺	轰隆	轰轰隆隆
烘烘	吱吱
哗哗	哗啦	潺潺	活活	汩汩	淙淙	呜咽	哗啦啦
冬冬	咚咚
嘡嘡	铮铮	当
丁零	丁丁
丁东	玲玲	叮咚
丁当	锒铛	丁零当郎
当啷	哐啷	哐
辘辘	轧	轧	咕隆
咯噔	噔	嘎登
吧唧	咕唧	吧哒
咿哑	咿呀	哑
咔嚓	吧	喀嚓	嘎巴	咔唑
嘎吱	咯吱	吱
沙沙	萧瑟	沙沙沙
吱喽	呀
笃笃	嗒嗒
梆	砰	乓	乒乓	乒	咣	乒乒乓乓
嗒嗒	哒
突突	怦	嘣	怦怦
噼啪	啪	噼噼啪啪
扑漉	拨剌	扑簌簌
喀哒	吧嗒	啪达
刷拉	砉	嚓
刺	哧	咝	嗖	噌	咝儿
咕咚	扑通	扑腾	扑	咚	嘭
嘟嘟	呜	啼呜	咕嘟嘟	嘟
轰隆	嗡嗡	轰	轰轰
早安	早
再见	再会	回见
失陪	少陪	告退	告辞	敬辞
慢走	好走	后会有期
请问	借问	借光	试问
指教	赐教	见教	请教	求教	讨教	就教	不吝指教
候教	聆教
承蒙	承情	承	蒙	辱
赏光	赏脸	给面子
打扰	打搅	扰
劳驾	劳神	劳动	烦劳	麻烦	烦	劳	累	辛苦	分神	费心	费神	费事	难为	费尽周折	劳心
抱歉	对不起	对不住
久仰	久仰大名	久慕盛名
久违	少见
怠慢	失敬	失礼	不周	怠
失迎	有失远迎
请便	听便	自便	悉听尊便
恭喜	恭贺	贺喜
托福	借光
谢谢	多谢	有劳
不谢	不敢当	别客气	好说	彼此彼此
过奖	过誉